program_id,county,site_address,foodborne_illness_violations,good_retail_practices_violations,total_violations,inspScore
1 UP Greenwood Village,Arapahoe,6864 S Clinton Ct,2,6,8,48
123 Pho,Douglas,11804 E Oswego St Unit C,4,4,8,48
125 Chinese Restaurant,Adams,10255 Washington St,3,6,9,47
135 Scoop,Arapahoe,3494 S Federal Blvd,7,8,15,41
20 Mile Tap House,Douglas,12543 N Highway 83,1,4,5,51
212 Pizza Co,Douglas,848 N Ridge Rd Unit F,2,0,2,54
3 Margaritas,Adams,14697 Delaware St Unit 800,3,4,7,49
3 Margaritas,Adams,3202 E 104th Ave,12,9,21,35
3 Margaritas,Adams,530 E Bromley Ln Unit 125,4,8,12,44
3 Margaritas,Arapahoe,25791 E Smoky Hill Rd Ste 100,2,5,7,49
30/70 Sports Bar and Grill,Adams,1885 W 120th Ave Ste 1300,11,4,15,41
303 Coffee Company,Arapahoe,8283 S Akron St Ste 170,3,4,7,49
47 Sushi and Spirits,Douglas,1525 Park Central Dr Unit 400,7,1,8,48
4Gs Cafe II,Arapahoe,3866 S Broadway,3,1,4,52
4Gs Cafe South,Arapahoe,5950 S Platte Canyon Rd Unit,10,13,23,33
5280 Bahn Mi and Grill,Arapahoe,15473 E Hampden Ave Unit A,0,0,0,56
5280 Burger Bar,Adams,4301 Main St,5,7,12,44
7 Corners Market,Arapahoe,4619 E Mississippi Ave,2,1,3,53
7 Star Food Mart,Arapahoe,4690 S Yosemite St Unit B,3,0,3,53
A Cake Occasion,Adams,3901 E 112th Ave Unit C,4,5,9,47
A Nutrition,Adams,726 W 120th Ave,0,3,3,53
A and A Commissary,Arapahoe,4695 S Windermere St,0,1,1,55
AB Petroleum 32,Adams,400 E 104th Ave,2,11,13,43
ACC Cafe,Arapahoe,5900 S Santa Fe Dr,3,3,6,50
ACCRA Kumasi African Market,Arapahoe,306 S Ironton St Unit E,2,4,6,50
AE Gas and Food,Adams,7490 Pecos St,1,1,2,54
AECOM Cafeteria,Arapahoe,6200 S Quebec St,2,2,4,52
AFC Sushi at Safeway 2722,Douglas,8355 N Rampart Range Rd,0,0,0,56
AMC Theatre Arapahoe Crossing 16 60540,Arapahoe,6696 S Parker Rd,4,5,9,47
AMC Theatre Castle Rock 12 61270,Douglas,3960 Limelight Ave,3,6,9,47
AMC Theatre Twenty Mile 10 67250,Douglas,18625 Stage Run Rd,2,6,8,48
AMC Theatres Brighton 12 60960,Adams,250 Pavilions Pl,4,3,7,49
AMC Theatres Highlands Ranch 24,Douglas,103 Centennial Blvd,2,3,5,51
AMF Aurora Bowling 330,Arapahoe,16700 E Mississippi Ave,1,1,2,54
AMF Belleview 304,Arapahoe,4900 S Federal Blvd,3,1,4,52
AMF Northglenn 358,Adams,310 W 104th Ave,2,4,6,50
AMF Sonesta Lanes 295,Adams,8800 Grant St,7,5,12,44
AOP Courtyard Cafe,Adams,12605 E 16th Ave,1,2,3,53
AS and DC Conoco,Arapahoe,16920 E Quincy Ave,2,2,4,52
ASA Sushi,Arapahoe,5302 DTC Blvd Unit 100,7,1,8,48
ATA Sushi and Sashimi,Arapahoe,2000 S Havana St,3,1,4,52
AXL Academy,Arapahoe,14100 E Jewell Ave,0,0,0,56
Abos Pizza,Douglas,2229 W Wildcat Reserve Pkwy Unit A1,4,5,9,47
Abos Pizza Northglenn,Adams,2145 E 120th Ave Unit F,4,5,9,47
Academy Charter School,Douglas,1551 Prairie Hawk Dr,0,0,0,56
Academy North Campus,Adams,12161 Park Center Dr,0,0,0,56
Academy The,Adams,11800 Lowell Blvd,0,3,3,53
Academy of Advance Learning,Arapahoe,441 Sable Blvd,1,1,2,54
Achieve Academy,Adams,9100 Poze Blvd,1,2,3,53
Acres,Arapahoe,3999 S Broadway,5,2,7,49
Acres Green Elementary,Douglas,13524 N Acres Green Dr,0,0,0,56
Adams City High School Bistro,Adams,7200 Quebec Pkwy,0,0,0,56
Adams City Middle School,Adams,4451 E 72nd Ave,1,2,3,53
Adams County Head Start Kitchen,Adams,11860 Pecos St,0,2,2,54
Adams County Parks Department,Adams,9755 Henderson Rd,2,3,5,51
Adams County Sheriff Detention Facility,Adams,150 N 19th Ave,1,5,6,50
Addes Catering Kitchen,Arapahoe,1670 Jasper St Unit H,0,2,2,54
Addis Ababa,Arapahoe,2222 S Havana St Unit B,4,6,10,46
Adelitas Kitchen,Adams,4975 W 80th Ave Unit C,1,0,1,55
Adrianas Restaurant,Douglas,7272 E Highway 86,6,6,12,44
Afghan Kabob,Adams,1975 W 120th Ave Unit 600,6,5,11,45
African International Market,Arapahoe,18801 E Hampden Ave Unit 170,6,3,9,47
Africanes Market,Arapahoe,10004 E Colfax Ave,4,4,8,48
Agfinity Inc,Adams,55 W Bromley Ln,2,6,8,48
Air Culinare Worldwide,Arapahoe,6860 S Clinton Ct Unit 1,7,10,17,39
Ajuua,Arapahoe,14150 E Iliff Ave,7,3,10,46
Aki Asian Hot Pot,Arapahoe,12303 E Mississippi Ave,5,4,9,47
Aki Japanese Cuisine,Arapahoe,3484 S Broadway,8,3,11,45
Alamo Drafthouse Cinema,Arapahoe,7301 S Santa Fe Dr Unit 850,2,1,3,53
Albasha Grill,Arapahoe,2260 S Quebec St Unit 7,4,4,8,48
Alexs Deli,Arapahoe,6560 Greenwood Plaza Blvd Unit 170,3,1,4,52
Alibis Bar and Grill,Arapahoe,7983 S Broadway,5,6,11,45
Alice Terry Elementary,Arapahoe,4485 S Irving St,0,1,1,55
All Health Network Bridge-ATM,Arapahoe,6507 S Santa Fe Dr,2,0,2,54
All Health Network Ctr Point,Arapahoe,2200 W Berry Ave,0,0,0,56
All Souls Catholic School,Arapahoe,4950 S Logan St,3,2,5,51
All Vegan all the Time,Arapahoe,15821 E Centretech Cir,1,0,1,55
Allegro Coffee Company,Adams,12799 Claude Ct,1,1,2,54
Alley The,Arapahoe,2420 W Main St Ste 110,0,0,0,56
Almustafa Market,Arapahoe,2159 S Parker Rd,3,6,9,47
Aloft Denver International Airport,Adams,16470 E 40th Cir,10,5,15,41
Alpine Adult Daycare,Arapahoe,1985 S Havana St,3,2,5,51
Alsup Elementary,Adams,7101 Birch St,0,0,0,56
Alta Convenience,Adams,1351 E Bridge St,2,3,5,51
Alta Convenience,Adams,2301 E 88th Ave,1,1,2,54
Alta Convenience,Adams,2387 W 72nd Ave,0,1,1,55
Alta Convenience,Adams,9190 Huron St,1,1,2,54
Alta Convenience,Douglas,800 S Wilcox St,3,6,9,47
Alta Convenience 1340,Arapahoe,15201 E Hampden Ave,3,1,4,52
Alta Convenience 6017,Arapahoe,7450 S Colorado Blvd,2,0,2,54
Alta convenience,Douglas,11515 N Highway 83,2,1,3,53
Altura Elementary,Adams,1650 Altura Blvd,1,0,1,55
Alumia Institute,Arapahoe,9800 E Geddes Ave Ste 50,1,2,3,53
Amaravati Indian Cuisine,Douglas,9234 Park Meadows Dr,10,10,20,36
AmazonFresh - UC01,Adams,480 E 55th Ave,0,1,1,55
American Academy Castle Pines,Douglas,6971 Mira Vista Ln,0,0,0,56
American Academy Lincoln Meadows,Douglas,10260 Twenty Mile Rd,0,0,0,56
American Academy PKR - Nutrition Services,Douglas,11155 Motsenbocker Rd,1,3,4,52
American Convenience Store,Adams,285 E 88th Ave,1,3,4,52
American Convenience Store 2,Adams,11340 Huron St,1,1,2,54
American Family Cafe,Douglas,9510 S Meridian Blvd,0,4,4,52
Amigos Mexican Food,Arapahoe,6831 S Dayton St,3,4,7,49
Ananda Bazaar,Arapahoe,3102 S Parker Rd Unit A6,4,3,7,49
Anas Mexican Grill,Adams,2821 W 120th Ave Unit 100,2,3,5,51
Anayas Bakery and Suplay,Adams,1550 Sable Blvd,8,9,17,39
Andys Frozen Custard,Arapahoe,3505 River Point Pkwy,3,3,6,50
Andys Frozen Custard,Arapahoe,6985 S Broadway,3,0,3,53
Angelos Tavern & Carboy Winery,Arapahoe,6885 S Santa Fe Dr,4,5,9,47
Angies Restaurant,Douglas,201 4th St,7,6,13,43
Angry Chicken,Arapahoe,1930 S Havana St Unit 13,3,3,6,50
Antelope Ridge Elementary,Arapahoe,5455 S Tempe St,0,2,2,54
Antepian Turkish Cuisine,Arapahoe,2767 S Parker Rd,5,2,7,49
Anthonys II,Adams,3901 E 112th Ave Unit RS,3,1,4,52
Anthonys Pizza and Pasta,Arapahoe,17150 E Iliff Ave Unit A2,0,0,0,56
Anthonys Pizza and Pasta,Arapahoe,20269 E Smoky Hill Rd,6,5,11,45
Anthonys Pizza and Pasta,Arapahoe,2610 W Belleview Ave Ste 100,1,4,5,51
Anthonys Pizza and Pasta,Arapahoe,6860 S Clinton Ct Unit A,5,7,12,44
Anthonys Pizza and Pasta,Douglas,3506 Town Center Dr Unit E,1,4,5,51
Anthonys Pizza and Pasta,Douglas,880 W Happy Canyon Rd Ste 105,10,7,17,39
Anthonys Pizza and Pasta,Douglas,9234 Park Meadows Dr Ste 300,2,3,5,51
Anthonys Pizza and Pasta 16,Douglas,17001 Lincoln Ave Unit F,2,5,7,49
Antojitos Hondurenos,Adams,11703 E Colfax Ave,5,5,10,46
Antonios Pizza Pasta Wings,Douglas,12947 S Parker Rd,7,4,11,45
Apple Junction Barbecue Catering,Adams,14694 Orchard Pkwy Unit 700,2,0,2,54
Apple Spice,Arapahoe,7346 S Alton Way Unit 10G,4,2,6,50
Applebees Neighborhood Grill and Bar,Adams,100 W 104th Ave,3,6,9,47
Applebees Neighborhood Grill and Bar,Arapahoe,14091 E Iliff Ave,1,1,2,54
Applebees Neighborhood Grill and Bar,Arapahoe,16485 E 40th Cir,5,12,17,39
Applebees Neighborhood Grill and Bar,Arapahoe,8292 S University Blvd,0,3,3,53
Applebees Neighborhood Grill and Bar,Douglas,390 W Allen St,1,3,4,52
Applebees Neighborhood Grill and Bar 28,Adams,297 E 120th Ave,3,6,9,47
Applebees Neighborhood Grill and Bar 39,Adams,922 S 4th Ave,2,6,8,48
Applebees Restaurant,Arapahoe,10501 E Garden Dr,3,1,4,52
Aramark Arrow Campus,Arapahoe,9151 E Panorama Cir,3,5,8,48
Aramark Correctional Services Inc 3175,Adams,1450 E 62nd Ave,2,1,3,53
Aramark Sports and Entertainment Dicks Sport Good,Adams,6000 Victory Way,1,5,6,50
Aramark at Tele -Tech,Douglas,9197 S Peoria St,5,10,15,41
Aramark at Time To Change,Adams,4901 Krameria St,2,2,4,52
Arapahoe Bowling Center,Arapahoe,6850 S Dayton St,4,9,13,43
Arapahoe Cafe,Arapahoe,7325 S Potomac St,1,2,3,53
Arapahoe County Residential Center,Arapahoe,2135 W Chenango Ave,0,1,1,55
Arapahoe High School,Arapahoe,2201 E Dry Creek Rd,0,0,0,56
Arapahoe Justice Center Aramark,Arapahoe,7375 S Potomac St,1,5,6,50
Arapahoe Library District Cafe,Arapahoe,5955 S Holly St,3,1,4,52
Arapahoe Park,Arapahoe,26000 E Quincy Ave,5,7,12,44
Arapahoe Ridge Elementary,Adams,13095 Pecos St,0,0,0,56
Arash Groceries and Deli Inc,Arapahoe,2720 S Parker Rd,5,2,7,49
Arbys - 5010025,Douglas,7455 Park Meadows Dr,3,3,6,50
Arbys - 5010039,Douglas,12245 Lioness Way,0,2,2,54
Arbys 5009013,Adams,15190 Brighton Rd,1,0,1,55
Arbys 5009015,Adams,2133 Prairie Center Pkwy,1,3,4,52
Arbys 5009016,Adams,3903 E 120th Ave,1,2,3,53
Arbys 5009019,Adams,501 E 84th Ave,1,2,3,53
Arbys 5009022,Adams,200 E 144th Ave,3,6,9,47
Arbys 5009023,Adams,850 W 104th Ave,1,1,2,54
Arbys 5009028,Adams,5995 Dexter St,1,0,1,55
Arbys 5009029,Adams,5130 W 92nd Ave,2,3,5,51
Arbys 5009038,Adams,7055 N Federal Blvd,1,2,3,53
Arbys 5010028,Arapahoe,161 W Mineral Ave,0,3,3,53
Arbys 5010035,Arapahoe,5685 S Broadway,2,0,2,54
Arbys 5010036,Douglas,9831 S Parker Rd,1,2,3,53
Arbys 5010037,Arapahoe,6626 S Yosemite Ct,2,2,4,52
Arbys 5010038,Douglas,742 Genoa Way,2,2,4,52
Arbys 5010040,Arapahoe,14475 E Arapahoe Rd,5,2,7,49
Arbys 5010043,Arapahoe,1099 S Blackhawk St,5,8,13,43
Arbys 5010044,Arapahoe,4350 S Buckley Rd,2,7,9,47
Arbys 5010045,Arapahoe,2260 S Parker Rd,3,2,5,51
Aris Tavern,Adams,5686 Pecos St,0,1,1,55
Arkansas Elementary,Arapahoe,17301 E Arkansas Ave,1,1,2,54
Armandos Ristorante,Douglas,9355 Crown Crest Blvd,3,4,7,49
Arrowhead Elementary,Arapahoe,19100 E Bates Ave,0,0,0,56
Arrowhead Golf Club,Douglas,10850 Sundown Trl,5,6,11,45
Arrowwood Elementary,Douglas,10345 Arrowwood Dr,0,1,1,55
Artisan Pizza,Douglas,12311 Pine Bluffs Way,1,5,6,50
Asia Inn Restaurant,Adams,479 S 4th Ave,6,10,16,40
Asian Buffet CO Inc,Adams,10695 Melody Dr,6,0,6,50
Asian Island Sushi and Grill,Adams,16566 Washington St,6,6,12,44
Aspen Crossing Elementary,Arapahoe,4655 S Himalaya St,0,2,2,54
Aspen View Academy - Nutrition Services,Douglas,2131 Low Meadow Blvd,0,2,2,54
Assumption School,Adams,2341 E 78th Ave,1,1,2,54
Asti D Italia,Adams,14648 Delaware St Unit 200,5,4,9,47
Asuka Inc,Arapahoe,5131 S Yosemite St,0,0,0,56
At Cheers,Adams,11964 Washington St,0,3,3,53
At Nine Thai,Arapahoe,8101 S Quebec St Unit C,4,0,4,52
Athenian Restaurant,Arapahoe,15350 E Iliff Ave,6,6,12,44
Atlanta Bread Company,Adams,351 W 104th Ave,4,4,8,48
Atlas Coffee,Douglas,8155 Piney River Ave,0,1,1,55
Atrium Cafe,Arapahoe,6061 S Willow Dr,1,0,1,55
Audi Quattro Cafe,Arapahoe,6060 S Broadway,2,3,5,51
August Moon Asian Grill,Douglas,18651 E Mainstreet,5,2,7,49
Aungs Bangkok Cafe,Arapahoe,1225 E Hampden Ave,3,1,4,52
Auntie Annes,Arapahoe,14200 E Alameda Ave Unit 2049A,1,1,2,54
Auntie Annes and Cinnabon,Douglas,5050 Factory Shops Blvd Unit 605,4,5,9,47
Aurora Academy Charter School,Arapahoe,10251 E 1st Ave,0,1,1,55
Aurora Central High School,Arapahoe,11700 E 11th Ave,2,2,4,52
Aurora City Sports Park,Arapahoe,18601 Sports Park Dr,3,2,5,51
Aurora Frontier K thru 8 School,Arapahoe,3200 S Jericho Way,0,0,0,56
Aurora Hills Middle School,Arapahoe,1009 S Uvalda St,0,1,1,55
Aurora Market,Arapahoe,1555 S Havana St Unit A,3,5,8,48
Aurora Mental Health Center,Arapahoe,12455 E Mississippi Ave,0,1,1,55
Aurora Processing Center,Arapahoe,3130 Oakland St,0,2,2,54
Aurora Quest Academy,Arapahoe,17315 E 2nd Ave,0,1,1,55
Aurora West College Preparatory Academy,Arapahoe,10100 E 13th Ave,0,2,2,54
Avalanche Grill,Arapahoe,6901 S Peoria St,3,2,5,51
Ave Maria Catholic School,Douglas,9056 E Parker Rd,1,1,2,54
Aviator Bar and Grill,Adams,5200 Front Range Pkwy,4,2,6,50
Ay Guey Mexican Snacks,Adams,3947 E 120th Ave Ste B,3,5,8,48
B & B Cafe,Douglas,322 Wilcox St,2,9,11,45
BJs Restaurant and Brewhouse,Arapahoe,14442 E Cedar Ave,3,1,4,52
BQ Food and Spirits,Arapahoe,16961 E Quincy Ave Unit C1,3,2,5,51
Babajoons Restaurant,Adams,1005 W 120th Ave Ste 200,2,3,5,51
Babes Restaurant and Lounge,Adams,2265 W 84th Ave,3,4,7,49
Backstreet Tavern & Grill Inc,Arapahoe,1150 S Galena St,3,2,5,51
Bacon Social House,Arapahoe,2100 W Littleton Blvd,7,3,10,46
Bad Daddys Burger Bar,Adams,100 E 120th Ave Unit B120,7,7,14,42
Bad Daddys Burger Bar,Arapahoe,23955 E Plaza Ave Unit G107,3,3,6,50
Bad Daddys Burger Bar,Arapahoe,5380 Greenwood Plaza Blvd Ste 110,0,0,0,56
Bad Daddys Burger Bar 205,Arapahoe,2151 E Briarwood Ave Ste 621,1,4,5,51
Bagel Stop Cafe,Douglas,10401 S Parker Rd Unit 125,0,0,0,56
Bakers Way,Arapahoe,8181 E Arapahoe Rd Unit C,0,0,0,56
Bali Deli,Arapahoe,6455 S Yosemite St Ste 130,3,1,4,52
Bangkok Tokyo Asian Fusion Inc,Arapahoe,6020 S Gun Club Rd,3,8,11,45
Bar Elevate,Adams,2831 W 120th Ave Ste 200,8,8,16,40
Bar Louie,Arapahoe,8000 E Belleview Ave,1,4,5,51
Bar Louie Restaurant and Bar,Arapahoe,6100 S Main St Ste 104,4,4,8,48
Bara Sushi and Thai Asian Cuisine,Arapahoe,8000 E Belleview Ave Unit D50,2,1,3,53
Baris Pizza,Adams,16603 N Washington St,3,6,9,47
Barnacle Cafe,Arapahoe,1225 W Belleview Ave,3,1,4,52
Barnes and Noble Booksellers 2091,Adams,701 E 120th Ave,0,1,1,55
Barnes and Noble Booksellers 2245,Arapahoe,6300 S Main St Ste 101,2,2,4,52
Barwaaqo Restaurant,Arapahoe,10200 E Mississippi Ave Ste B,4,5,9,47
Baskin Robbins,Adams,8424 Federal Blvd,1,7,8,48
Baskin Robbins,Arapahoe,14200 E Alameda Ave Unit 2071A,1,2,3,53
Baskin Robbins,Arapahoe,16861 E Iliff Ave,0,4,4,52
Baskin Robbins PC 348692,Douglas,3626 E Highlands Ranch Pkwy Unit 209 9,0,2,2,54
Bawarchi Biryani Point,Arapahoe,11001 E Arapahoe Pl Unit B1,6,10,16,40
Beantree Coffee,Arapahoe,12101 E Iliff Ave Ste A,1,2,3,53
Bear Canyon Elementary,Douglas,9660 Salford Ln,0,0,0,56
Beau Thai II,Douglas,1341 New Beale St Ste 140,12,14,26,30
Beef Demonstration Center,Arapahoe,9110 E Nichols Ave Ste 300,2,2,4,52
Beirut Grill,Arapahoe,203 W Hampden Ave,12,8,20,36
Bella Sera,Adams,45 N Main St Unit 6,4,7,11,45
Bella Sera Event Center,Adams,45 Strong St,0,1,1,55
Belle Creek Charter School,Adams,9290 E 107th Ave,2,1,3,53
Belleview Elementary,Arapahoe,4851 S Dayton St,0,0,0,56
Beltrans Meat Market,Adams,11920 Washington St Unit B,8,4,12,44
Ben Franklin Pool - Snack Bar,Arapahoe,1600 E Panama Dr,4,0,4,52
Benders Brat Haus,Arapahoe,700 S Buckley Rd Unit A,6,1,7,49
Benedicts Restaurant,Arapahoe,8181 E Arapahoe Rd Ste A,3,3,6,50
Bennett Elementary,Adams,462 8th St,0,2,2,54
Bennett High School Concession,Adams,505 8th St,4,4,8,48
Bennett Middle School,Adams,455 8th St,0,0,0,56
Bennett Travel Shoppe,Adams,1210 S 1st St,3,1,4,52
Bent Fork American Grill,Arapahoe,12191 E Iliff Ave,2,5,7,49
Bent Noodle,Arapahoe,3055 S Parker Rd Unit A108,3,3,6,50
Berg Haus The,Douglas,7280 Lagae Rd Unit A-111,1,3,4,52
Berry Blendz,Adams,1281 E 120th Ave,1,1,2,54
Berry Blendz,Douglas,10941 S Parker Rd,0,2,2,54
Berry Blendz,Douglas,8401 Park Meadows Center Dr,3,6,9,47
Best One Convenience Store,Adams,6898 Kearney St,1,0,1,55
Best Philly Steak,Adams,6350 Sheridan Blvd Ste 115B,4,3,7,49
Best Western Brighton Inn,Adams,15151 Brighton Rd,4,2,6,50
Bibi Poke at Centennial,Arapahoe,12023 E Arapahoe Rd Ste 140,4,1,5,51
Bibimbap and Naked Grill 153,Arapahoe,10639 E Briarwood Ave Unit B2,10,8,18,38
Big Apple Mart 2,Douglas,2195 N Highway 83,2,8,10,46
Big Bills New York Pizza,Arapahoe,8243 S Holly St,0,2,2,54
Big Daddy Mexican Restaurant,Adams,7584 Highway 2,2,0,2,54
Big Daddys Pizza,Arapahoe,1155 S Havana Ave Ste 69,1,1,2,54
Big Daddys Pizza,Arapahoe,5829 S Broadway,3,1,4,52
Big Lots,Adams,893 S Kuner Rd,0,1,1,55
Big Lots 1914,Arapahoe,7475 Iliff,1,0,1,55
Big Lots 1920,Arapahoe,139 W Hampden Ave,0,0,0,56
Big Lots 4133,Arapahoe,15351 E Hampden Ave,1,0,1,55
Big Lots 4486,Adams,4830 W 120th Ave,0,0,0,56
Big Mac and Little Lus Seafood,Adams,2851 W 120th Ave Unit 300A,5,4,9,47
Big Mamas Burritos,Adams,3190 W 72nd Ave,3,4,7,49
Big Mamas Burritos 3,Adams,7790 Federal Blvd,2,4,6,50
Big Panda,Adams,15550 E 103rd Pl Ste 101,7,5,12,44
Big Picture College and Career Academy,Adams,7350 N Broadway Ste 200,1,0,1,55
Billies,Adams,1830 E Bridge St,7,9,16,40
Bingo Oasis,Adams,10657 Melody Dr,2,5,7,49
Birds Nest Express,Arapahoe,10605 E Mississippi Ave,6,5,11,45
Birrieria Y Taqueria Los Tecos LLC,Adams,7353 Pecos St,3,1,4,52
Bishop Elementary School,Arapahoe,3100 S Elati St,0,0,0,56
Bison Grill,Adams,15700 E 112th Ave,6,5,11,45
Bistro,Douglas,3775 Grace Blvd Bldg B,1,1,2,54
Bistro King Thai and Sushi,Arapahoe,3542 S Fox St,2,10,12,44
Bitto Bistro,Adams,14697 Delaware St Unit 1000,4,7,11,45
Black Bear Golf Club,Douglas,11400 Canterberry Pkwy,3,5,8,48
Black Cow Deli,Arapahoe,7670 S Chester St,8,10,18,38
Black Cow Deli II,Arapahoe,600 S Cherry St Unit 25,4,6,10,46
Black Eyed Pea,Adams,211 W 104th Ave,2,5,7,49
Black Eyed Pea,Arapahoe,5180 S Broadway,5,5,10,46
Black Eyed Pea,Douglas,850 New Memphis Ct,2,9,11,45
Black Forest Hills Elementary,Arapahoe,25233 E Glasgow Dr,0,1,1,55
Black Rock Coffee Bar,Douglas,4985 Factory Shops Blvd Ste 100,0,0,0,56
Black Sea Grocery,Arapahoe,7920 E Mississippi Ave Ste M,3,2,5,51
Black eyed Pea,Douglas,9205 Crown Crest Blvd,0,0,0,56
Blackjack Pizza,Adams,8410 Federal Blvd,4,6,10,46
Blackjack Pizza,Arapahoe,13696 E Alameda Ave,1,1,2,54
Blackjack Pizza,Arapahoe,16961 E Quincy Ave Unit C6,3,5,8,48
Blackjack Pizza,Arapahoe,7500 S University Blvd Unit 107,4,5,9,47
Blackjack Pizza,Arapahoe,9625 E Arapahoe Rd,4,2,6,50
Blackjack Pizza,Douglas,9821 S Parker Rd,2,3,5,51
Blackjack Pizza 2026,Adams,14296 Lincoln St,2,2,4,52
Blackjack Pizza of Brighton,Adams,1521 E Bridge St # 2,1,8,9,47
Blackstone Country Club,Arapahoe,7777 S Country Club Pkwy,8,10,18,38
Bleu Sage Catering,Adams,1500 E 128th Ave,7,7,14,42
Blimpies,Arapahoe,14101 E Exposition Ave,3,1,4,52
Blu Note Bar and Grill,Douglas,19600 Solar Cir,3,2,5,51
Blue Bay Asian Cafe,Adams,12840 Holly St Unit 180,4,11,15,41
Blue Mountain Kitchen,Adams,16607 N Washington St,2,2,4,52
Blue Note Catering (Fiddlers Green),Arapahoe,6350 Greenwood Plaza Blvd,1,2,3,53
Bluebird Cafe,Adams,885 Thornton Pkwy,8,5,13,43
Boardroom,Arapahoe,51 W Dry Creek Ct,2,2,4,52
Boardwalk Pizzeria Inc,Adams,1420 W 104th Ave,3,7,10,46
Bombay Bazaar,Arapahoe,3140 S Parker Rd Ste 4,0,4,4,52
Bonbons,Adams,1675 W 67th Ave Unit 300,1,0,1,55
Bonefish Grill,Arapahoe,4948 S Yosemite St Unit,1,4,5,51
Bonos BBQ,Arapahoe,9393 E Dry Creek Rd,2,7,9,47
Bookmakers Burgers Bourbon and Brews,Arapahoe,25791 E Smoky Hill Rd Ste 50,3,3,6,50
Boondocks Food and Fun,Douglas,18706 Cottonwood Dr,4,3,7,49
Boondocks Fun Center,Adams,11425 Community Center Dr,5,5,10,46
Born2bake,Arapahoe,2540 W Main St,9,11,20,36
Bosphorus,Arapahoe,3493 S Downing St,7,5,12,44
Boston Elementary,Arapahoe,1365 Boston St,1,3,4,52
Boston Market 1755,Arapahoe,14110 E Iliff Ave,2,7,9,47
Boston Market 207,Arapahoe,8507 E Arapahoe Rd,2,2,4,52
Botanas Locas,Arapahoe,2271 S Peoria St,3,1,4,52
Bout Time Pub and Grub,Arapahoe,3580 S Platte River Dr Ste A,2,5,7,49
Bow Mart,Arapahoe,5198 S Lowell Blvd,2,0,2,54
Bowlero Heather Ridge,Arapahoe,2200 S Peoria St,3,6,9,47
Bowlero Littleton,Douglas,2530 E County Line Rd,3,3,6,50
Bowlero Lone Tree,Douglas,9255 Kimmer Dr,5,8,13,43
Bowmar Gas Express,Arapahoe,5200 S Lowell Blvd,6,7,13,43
Boyds Tasty Expressions,Adams,12189 Pennsylvania St,0,0,0,56
Brads Pit BBQ,Arapahoe,5950 S Platte Canyon Rd Unit D18,0,0,0,56
Brantner Elementary,Adams,7800 E 133rd Ave,1,0,1,55
Bravos Italian Restaurant,Adams,10691 Melody Dr Unit C & E,4,5,9,47
Bread in the Box,Douglas,1605 Park St Ste A,2,1,3,53
Break Time Conoco,Arapahoe,15015 E Hinsdale Dr,1,0,1,55
Breakfast Queen,Arapahoe,3460 S Broadway,3,5,8,48
Breakfast on Broadway Cafe,Arapahoe,2901 S Broadway,2,1,3,53
Breckenridge Brewery (The Farmhouse),Arapahoe,2990 Brewery Ln,2,5,7,49
Brewery Bar III,Douglas,9228 Park Meadows Dr,3,4,7,49
Brewskis Pub and Grill,Adams,2100 E 104th Ave,9,2,11,45
Briccys Coffee,Douglas,140 S Wilcox St Unit C,1,3,4,52
Brick House Tavern & Tap,Douglas,19320 Cottonwood Dr,4,7,11,45
Brighton High School,Adams,360 S 8th Ave,2,7,9,47
Brighton Learning and Resource Center,Adams,1850 E Egbert St,1,2,3,53
Brighton Meal Site VOA,Adams,1150 Prairie Center Pkwy,0,2,2,54
Brighton Sport Park Concession,Adams,1111 Judicial Center Dr,3,5,8,48
Brio Tuscan Grille,Douglas,8441 Park Meadows Center Dr,4,7,11,45
Britstop Cafe,Douglas,221 Perrt St,0,1,1,55
Broadway Sinclair,Adams,6185 N Broadway Ave,0,2,2,54
Broadways Shot Spot,Arapahoe,4011 S Broadway Unit 103,0,1,1,55
Broken Tee Grill,Arapahoe,2101 W Oxford Ave,6,7,13,43
Bromley East Charter School,Adams,356 Longspur Dr,0,1,1,55
Bronco Bar,Adams,9496 E Montview Blvd,4,4,8,48
Brooks Smokehouse Catering BBQ & Cajun Cuisine,Arapahoe,800 Oakland St,4,0,4,52
Brothers BBQ,Arapahoe,9069 E Arapahoe Rd,0,0,0,56
Brothers BBQ,Douglas,5544 Promenade Pkwy,0,0,0,56
Brothers Bar & Grill,Douglas,7407 Park Meadows Dr,1,3,4,52
Brothers Kitchen,Adams,7155 Newport St,3,5,8,48
Bua,Arapahoe,950 S Abilene St,3,3,6,50
Bubba Chinos,Adams,201 S Main St,5,8,13,43
Bubba Chinos 20,Adams,5595 Federal Blvd,3,5,8,48
Bubbas 33,Arapahoe,2270 S Parker Rd,3,1,4,52
Buds Bar,Douglas,5453 Manhart St,4,2,6,50
Buffalo Ridge Elementary,Douglas,7075 N Shoreham Dr,1,1,2,54
Buffalo Trail Elementary,Arapahoe,24300 E Progress Dr,1,3,4,52
Buffalo Wild Wings 190,Adams,10090 Grant St,2,5,7,49
Buffalo Wild Wings 214,Adams,2025 Prairie Center Pkwy,3,3,6,50
Buffalo Wild Wings 264,Adams,16540 Washington St,3,6,9,47
Buffalo Wild Wings 300,Arapahoe,10500 E Garden Dr,1,4,5,51
Buffalo Wild Wings 381,Douglas,908 Sgt Jon Stiles Dr,1,4,5,51
Buffalo Wild Wings 648,Arapahoe,3900 River Point Pkwy,2,3,5,51
Buffalo Wild Wings 669,Arapahoe,6100 S Main St,2,2,4,52
Buffalo Wild Wings 95,Arapahoe,8255 S Chester St Unit 200,4,5,9,47
Buffet City Brighton,Adams,50 N Main St,5,11,16,40
Bull and Bush,Arapahoe,4700 Cherry Creek Dr,1,6,7,49
Bundt Shoppe,Douglas,7437 Village Square Dr Ste 125,0,4,4,52
Bundt Shoppe,Douglas,9315 Dorchester St G 109,0,2,2,54
Bundt Shoppe The,Arapahoe,5910 S University Blvd Unit C16,3,1,4,52
Burger King,Adams,520 E 58th Ave,1,3,4,52
Burger King,Adams,650 E 120th Ave,5,4,9,47
Burger King,Adams,7255 Pecos St,1,3,4,52
Burger King,Arapahoe,5697 S Himalaya St,3,2,5,51
Burger King,Arapahoe,620 S Buckley Rd,1,2,3,53
Burger King,Arapahoe,900 W Hampden Ave,1,4,5,51
Burger King,Douglas,3520 Town Center Dr,1,6,7,49
Burger King,Douglas,4408 Barranca Ln,3,4,7,49
Burger King,Douglas,6675 Business Center Dr,1,1,2,54
Burger King,Douglas,880 Kinner St,0,7,7,49
Burger King 10685,Douglas,18811 Ponderosa Dr,1,3,4,52
Burger King 13779,Arapahoe,6712 S Potomac St,1,2,3,53
Burger King 16607,Arapahoe,2397 W Belleview Ave Unit A,2,5,7,49
Burger King 1814,Arapahoe,15290 E Colfax Ave,4,8,12,44
Burger King 18222,Arapahoe,2650 S Havana St,0,2,2,54
Burger King 1996,Arapahoe,12119 E Mississippi Ave,1,1,2,54
Burger King 2409,Adams,1505 E Bridge St,0,5,5,51
Burger King 2424,Arapahoe,15340 E Hampden Ave,2,3,5,51
Burger King 2889,Arapahoe,16850 E Iliff Ave,1,2,3,53
Burger King 3609,Arapahoe,7480 S University Blvd,1,3,4,52
Burger King 4268,Adams,2998 W 104th Ave,1,4,5,51
Burger King 457,Adams,666 E 104th Ave,2,6,8,48
Burger King 5688,Arapahoe,14090 E Mississippi Ave,0,5,5,51
Burger King 8097,Arapahoe,16706 E Smoky Hill Rd,0,3,3,53
Burger King 9400,Adams,3800 Chambers Rd,2,5,7,49
Burger King 9674,Adams,301 W 84th Ave,0,0,0,56
Burger Theory,Arapahoe,6638 S Nome St,2,2,4,52
Burgerim,Douglas,12231 Pine Bluffs Way Unit 109,3,1,4,52
Burnt Ends BBQ,Arapahoe,5332 DTC Blvd,2,2,4,52
Burrito Rapido,Adams,6089 Quebec St Unit B,6,4,10,46
Burritos and Company,Adams,5907 Washington St,3,2,5,51
Burtons,Douglas,2975 Summer Wind Ln,1,3,4,52
Butcher Block Cafe,Adams,4605 E 74th Ave,1,4,5,51
Byers General Store,Arapahoe,568 N Highway 36,6,4,10,46
Byers School,Adams,444 E Front St,1,1,2,54
C B Potts Big Horn Brewing Company,Adams,1257 W 120th Ave,4,9,13,43
C and K Food and Gas,Adams,5251 Pecos St,1,2,3,53
CJs Catering,Adams,101 N Main St,2,2,4,52
Cabelas,Adams,14050 N Lincoln St,3,0,3,53
Cafe 180,Arapahoe,3315 S Broadway,4,2,6,50
Cafe Allegro,Arapahoe,7400 E Orchard Rd Ste 100,1,0,1,55
Cafe Ambrosia,Arapahoe,20981 E Smoky Hill Rd,8,7,15,41
Cafe Cascade,Arapahoe,6300 S Syracuse Way,4,1,5,51
Cafe China,Douglas,10920 S Parker Rd Unit B3,2,5,7,49
Cafe Mexico I,Adams,3815 W 72nd Way,2,6,8,48
Cafe Mexico II,Adams,810 E 120th Ave,4,2,6,50
Cafe One,Arapahoe,5251 DTC Pkwy Ste P3,5,0,5,51
Cafe Paprika,Arapahoe,13160 E Mississippi Ave,3,6,9,47
Cafe Rio Mexican Grill,Adams,100 E 120th Ave Unit C140,3,6,9,47
Cafe Rio Mexican Grill,Arapahoe,610 S Colorado Blvd Ste A,1,2,3,53
Cafe Rio Mexican Grill,Arapahoe,6907 S University Blvd,2,1,3,53
Cafe Rio Mexican Grill,Douglas,832 New Memphis Ct Ste 120,1,3,4,52
Cafe Sol,Douglas,9049 Forsstrom Dr,3,0,3,53
Cafe Terra Cotta,Arapahoe,5649 S Curtice St,7,6,13,43
Cafe Typica,Arapahoe,4340 E Kentucky Ave Unit 145,1,2,3,53
Cafe du Coco,Arapahoe,2676 W Alamo Ave,3,4,7,49
Caitlins,Arapahoe,4379 E Mississippi Ave,3,1,4,52
Cajun and Grill,Douglas,8515 Park Meadows Center Dr Unit 3019,5,8,13,43
Cakeheads,Arapahoe,7530 S University Blvd Unit 105,4,3,7,49
Cakes By Karen,Adams,10691 Melody Dr # 1,3,6,9,47
California Pizza Kitchen,Douglas,8343 Park Meadows Center Dr,5,9,14,42
Calvary Chapel,Arapahoe,18900 E Hampden Ave,2,1,3,53
Cambria Suites,Adams,16001 E 40th Cir,4,8,12,44
Campus Middle School,Arapahoe,4785 S Dayton St,0,0,0,56
Cannoli Cafe,Douglas,18595 E Mainstreet 1st Flr,2,2,4,52
Canon Catering,Arapahoe,6518 S Broadway,5,2,7,49
Cantina Deportiva,Adams,6970 Eudora Dr,1,2,3,53
Canyon Creek Elementary,Arapahoe,6070 S Versailles Pkwy,0,0,0,56
Capitol Pizza,Adams,805 W 88th Ave,7,7,14,42
Capri Pizza,Adams,12720 Colorado Blvd Unit D2,7,6,13,43
Capri Pizza,Adams,2431 E 88th Ave,4,5,9,47
Carefree Cuisine,Arapahoe,3615 W Bowles Ave Unit 1,0,0,0,56
Caribou Coffee 1202,Adams,2721 W 120th Ave Bldg A,1,2,3,53
Caribou Coffee 1216,Arapahoe,13700 E Colfax Ave Ste C,1,3,4,52
Caribou Coffee and Einstein,Adams,14315 Orchard Pkwy Ste 600,3,3,6,50
Caribou Coffee and Einstein,Douglas,7120 E County Line Rd,4,0,4,52
Carlos Miguel Mexican Bar and Grill,Douglas,3982 Limelight Ave,5,4,9,47
Carmines Pizza and Pasta,Douglas,9500 Heritage Hills Cir Ste 500,7,7,14,42
Carniceria Aurora CO,Arapahoe,354 Havana St,2,0,2,54
Carniceria Compare,Arapahoe,541 Sable Blvd,5,4,9,47
Carniceria Dariana,Arapahoe,12028 E Mississippi Ave Unit B,3,5,8,48
Carniceria Del Norte,Adams,2401 E 88th Ave Unit A,6,4,10,46
Carniceria Dos Reales,Adams,8411 Pecos St Unit A,4,3,7,49
Carniceria El Rancho,Adams,573 S 4th Ave,8,11,19,37
Carniceria Jerezana,Arapahoe,1148 Yosemite St,9,3,12,44
Carniceria La Michoacana,Arapahoe,800 Dayton St,5,8,13,43
Carniceria La Pradera,Adams,5640 E 64th Ave,5,6,11,45
Carniceria La Superior,Arapahoe,1020 S Peoria St,5,4,9,47
Carniceria La Tapatia,Arapahoe,395 W Littleton Blvd Unit 5A,8,5,13,43
Carniceria La Victoria,Arapahoe,1436 Jamaica St Unit B,7,0,7,49
Carniceria Latina,Arapahoe,2272 S Chambers Rd,6,7,13,43
Carniceria Mexicana,Adams,9508 Montview Blvd,7,5,12,44
Carniceria Mi Mexico,Arapahoe,3102 S Parker Rd Ste A8-A9,4,2,6,50
Carniceria Mi Raza,Adams,1898 W 92nd Ave,2,10,12,44
Carniceria Taqueria La Consentida,Arapahoe,11651 E Montview Blvd,4,0,4,52
Carniceria Tarahumara,Adams,8993 N Washington St,0,3,3,53
Carniceria Y Abarrotes Chihuas,Adams,1135 E Bridge St,5,8,13,43
Carniceria Y Panaderia El Jakalito,Arapahoe,2260 S Quebec St Unit 1,4,3,7,49
Carniceria Y Panaderia Lyly,Arapahoe,16794 E Iliff Ave,1,2,3,53
Carniceria Y Taqueria El Tarazco,Adams,7575 Broadway Ste A,4,5,9,47
Carniceria y Taqueria la Pasadita,Adams,5330 Sheridan Blvd,5,5,10,46
Carniceria y Verduleria Guadalajara,Adams,1544 Lima St Unit A,7,3,10,46
Carroll Butts Ballfields,Adams,9427 Perry St,3,3,6,50
Casa Caliente,Douglas,8800 S Colorado Blvd Unit G,4,6,10,46
Casa Gutierrez,Arapahoe,12131 E Iliff Ave Unit D,3,3,6,50
Casa Mariachi,Douglas,9771 S Parker Rd,5,6,11,45
Casa Vallarta,Arapahoe,4002 S Parker Rd,8,10,18,38
Castaways,Adams,451 W 84th Ave,2,5,7,49
Castle Bar and Grill,Arapahoe,6657 S Broadway,2,2,4,52
Castle Cafe,Douglas,403 Wilcox St,4,12,16,40
Castle Pines Golf Club,Douglas,1000 Hummingbird Dr,3,2,5,51
Castle Rock Adventist Health,Douglas,2350 Meadows Blvd,4,8,12,44
Castle Rock Donuts,Douglas,300 W Allen St,5,3,8,48
Castle Rock Dream Ice Cream,Douglas,5050 Factory Shops Blvd Unit F20,1,5,6,50
Castle Rock Elementary,Douglas,1103 Canyon Dr,0,0,0,56
Castle Rock Middle School,Douglas,2575 Meadows Pkwy,0,0,0,56
Castle Rock Nutrition,Douglas,514 Perry St,0,0,0,56
Castle Rock Recreation Center,Douglas,2301 Woodlands Blvd,1,3,4,52
Castle View High School,Douglas,5254 Meadows Dr,5,2,7,49
Casual Lounge,Arapahoe,65 W Floyd Ave,1,4,5,51
Cazadorez Bar and Grill,Arapahoe,1470 Jamaica St,8,8,16,40
Cedar,Adams,1693 Quentin St,2,1,3,53
Cedar Creek Pub,Adams,2100 N Ursula St Unit 20,3,0,3,53
Celebrity Lanes,Arapahoe,15755 E Arapahoe Rd,1,3,4,52
Celtic House Pub,Douglas,16522 Keystone Blvd Ste H,1,2,3,53
Centennial Elementary,Arapahoe,3306 W Berry Ave,1,1,2,54
Central Elementary School,Adams,6450 Holly St,0,1,1,55
Centura Health,Arapahoe,9100 E Mineral Cir,5,8,13,43
Century Elementary,Arapahoe,2500 S Granby Way,0,0,0,56
Century KTV Asian Cafe,Arapahoe,1555 S Havana St Unit B,4,6,10,46
Century Middle School,Adams,13000 Lafayette St,1,0,1,55
Chagos Mexican Food,Arapahoe,16728 E Smoky Hill Rd Unit 11-I,0,0,0,56
Chai and Chai,Adams,12501 E 17th Ave Unit G,10,6,16,40
Challenge School,Arapahoe,9659 E Mississippi Ave,0,0,0,56
Challenge to Excellence Charter School,Douglas,16995 Carlson Dr,0,3,3,53
Challengers Sports Bar and Restaurant,Arapahoe,12161 E Iliff Ave,6,4,10,46
Chans Inn,Adams,3985 E 120th Ave,4,6,10,46
Chaparral High School,Douglas,15655 Brookstone Dr,0,0,0,56
Charitos House,Douglas,9080 Spruce Mountain Rd,6,8,14,42
Charles Hay World School,Arapahoe,3195 S Lafayette St,1,1,2,54
Charleys Grilled Subs,Arapahoe,14200 E Alameda Pkwy Unit 2066,1,3,4,52
Charleys Grilled Subs,Douglas,8515 Park Meadows Center Dr Unit 3013,5,5,10,46
Charleys Philly Steaks,Adams,13801 Grant St Unit 500,3,3,6,50
Charlies Crackle Corn,Adams,12189 Pennsylvania St,1,0,1,55
Chaserz Bar N Grill,Adams,7980 Sheridan Blvd,1,1,2,54
Cheddars Casual Cafe,Adams,10250 Grant St Unit 300,3,2,5,51
Cheddars Casual Cafe,Arapahoe,15775 E Briarwood Cir,3,2,5,51
Cheesecake Factory,Douglas,8405 Park Meadows Center Dr Unit 1001,6,7,13,43
Chef Ds,Arapahoe,14200 E Alameda Ave Unit 1024,5,3,8,48
Chef Steve,Arapahoe,15821 E Centretech Cir,1,0,1,55
Cherokee Trail Elementary,Douglas,17302 Clarke Farms Dr,0,3,3,53
Cherokee Trail High School,Arapahoe,25901 E Arapahoe Rd,0,1,1,55
Cherrelyn Elementary School,Arapahoe,4500 S Lincoln St,2,1,3,53
Cherry Creek Country Club,Arapahoe,2405 S Yosemite St,3,3,6,50
Cherry Creek Deli,Arapahoe,4500 Cherry Creek Dr Ste 106,6,8,14,42
Cherry Creek High School/Bruins Bistro,Arapahoe,9300 E Union Ave,0,0,0,56
Cherry Creek Innovation Campus-CCI Cafe,Arapahoe,8000 S Chambers Rd,0,0,0,56
Cherry Creek Presbyterian/ Community Life Center,Arapahoe,10000 E Belleview Ave,1,1,2,54
Cherry Creek Spa,Arapahoe,2333 S Yosemite St,0,2,2,54
Cherry Creek Student Nutrition Center,Arapahoe,14270 E Briarwood Ave,2,0,2,54
Cherry Crest Meat and Seafood,Arapahoe,5909 S University Blvd,8,10,18,38
Cherry Drive Elementary,Adams,11500 Cherry Dr,1,1,2,54
Cherry Hills Country Club,Arapahoe,4125 S University Blvd,6,3,9,47
Cherry Hills Sushi,Arapahoe,1400 E Hampden Ave Unit 110,3,0,3,53
Cherry Hills Village Elementary,Arapahoe,2400 E Quincy Ave,0,0,0,56
Cherry Thai,Arapahoe,13710 E Quincy Ave,8,13,21,35
Cherry Valley Elementary,Douglas,9244 S Highway 83,0,0,0,56
Cherry Village Asian Grill,Douglas,17001 Lincoln Ave Unit A,8,10,18,38
Chesters Philly Grill,Arapahoe,2195 S Chambers Rd,8,2,10,46
Chianti Ristorante Italiano,Arapahoe,5121 S Yosemite St,4,3,7,49
Chicago Mikes,Arapahoe,11405 E Briarwood Ave Ste 900,5,6,11,45
Chick Fil A,Adams,1301 E 120th Ave,3,3,6,50
Chick Fil A,Adams,14275 Orchard Pkwy,1,1,2,54
Chick Fil A,Adams,16670 Washington St,3,2,5,51
Chick Fil A,Arapahoe,14200 E Alameda Ave Unit 2062,1,0,1,55
Chick Fil A,Arapahoe,3085 S Broadway,1,0,1,55
Chick Fil A,Arapahoe,430 S Colorado Blvd,1,1,2,54
Chick Fil A,Arapahoe,5600 S Parker Rd,2,5,7,49
Chick Fil A,Arapahoe,6907 S University Blvd Ste 201-B,1,1,2,54
Chick Fil A,Arapahoe,7301 S Santa Fe Dr Unit 900,0,3,3,53
Chick Fil A,Arapahoe,9331 E Arapahoe Rd,3,2,5,51
Chick Fil A,Douglas,3700 E Highlands Ranch Pkwy,1,2,3,53
Chick Fil A,Douglas,9335 Crown Crest Blvd,2,9,11,45
Chick Fil A,Douglas,950 Cpl Max Donahue Ln,2,1,3,53
Chick Fil A Castle Rock FSU,Douglas,6353 Promenade Pkwy,0,0,0,56
Chick Fil A Gateway Park,Arapahoe,3444 N Salida St,2,4,6,50
Chick Fil A Riverpoint,Arapahoe,4090 River Point Pkwy,1,2,3,53
Chick Fil A at Alameda Ave,Arapahoe,14310 E Alameda Ave,1,1,2,54
Chick Fil A at Brighton FSU,Adams,2035 Prairie Center Pkwy,2,3,5,51
Chick Fil A at Castle Rock FSU,Douglas,346 Metzler Dr,2,3,5,51
Chick Fil A at Gardens on Havana,Arapahoe,1198 S Havana St,2,1,3,53
Chick Fil A at Southlands,Arapahoe,24400 E Smoky Hill Rd,1,4,5,51
Chick Fil A at Thorncreek,Adams,10280 Federal Blvd,2,1,3,53
Chick Fil A of Park Meadows Center,Douglas,8515 Park Meadows Center Dr Unit 3018,2,2,4,52
Chick Fil A of Park Meadows F S U,Douglas,9091 Westview Rd,7,9,16,40
Chicken Shack Aurora The,Arapahoe,6710 S Cornerstar Way Unit B,0,0,0,56
Chicken Shack Parker,Douglas,11211 S Dransfeldt Rd Ste 134,0,4,4,52
Chicken Teriyaki 6,Arapahoe,2225 S Peoria St,4,4,8,48
Childrens Health Pavilion - View Cafe,Arapahoe,860 Potomac Cir Flr 4,0,1,1,55
Childrens Hospital,Adams,13123 E 16th Ave Box 250,2,5,7,49
Childrens Hospital,Douglas,1811 Plaza Dr,0,0,0,56
Chilgogi Korean BBQ,Arapahoe,9666 E Arapahoe Rd,5,4,9,47
Chilis,Arapahoe,2070 E County Line Rd,4,4,8,48
Chilis Grill and Bar,Adams,2211 Prairie Center Pkwy,3,5,8,48
Chilis Grill and Bar,Adams,901 W 120th Ave,4,7,11,45
Chilis Grill and Bar,Arapahoe,265 S Abilene St,2,3,5,51
Chilis Grill and Bar,Arapahoe,6379 S Southlands Pkwy,1,3,4,52
Chilis Grill and Bar,Arapahoe,6646 S Parker Rd,3,3,6,50
Chilis Grill and Bar,Arapahoe,790 S Colorado Blvd,1,3,4,52
Chilis Grill and Bar,Douglas,10460 Park Meadows Dr,3,8,11,45
Chilis Grill and Bar,Douglas,11481 S Twenty Mile Rd,2,4,6,50
Chilis Grill and Bar,Douglas,800 New Memphis Ct,1,5,6,50
Chilis Grill and Bar 1230,Arapahoe,3451 Tower Rd,2,8,10,46
Chilis Grill and Bar 1274,Adams,16507 Washington St,5,2,7,49
Chilis Grill and Bar 1411,Arapahoe,3860 River Point Pkwy,6,9,15,41
China Cafe,Douglas,734 S Perry St Unit A,2,5,7,49
China Cafe 4,Arapahoe,16870 E Iliff Ave,4,4,8,48
China Chef,Arapahoe,636 Peoria St Unit A,6,6,12,44
China Chef Express,Arapahoe,980 S Peoria St Unit A,4,5,9,47
China Kitchen,Arapahoe,200 1st St,4,5,9,47
China Lee Zhuo Xing,Arapahoe,4662 S Yosemite St,3,2,5,51
China Taipei Restaurant,Arapahoe,8100 S Quebec St Unit B14,5,3,8,48
China Wok,Adams,4243 E 136th Ave Unit 312,3,7,10,46
Chinese Noodles,Arapahoe,12201 E Mississippi Ave Ste 123B,2,3,5,51
Chipotle Mexican Grill,Adams,3455 Salida St Unit D,2,2,4,52
Chipotle Mexican Grill,Adams,5160 W 120th Ave,1,4,5,51
Chipotle Mexican Grill,Adams,951 E 120th Ave,1,6,7,49
Chipotle Mexican Grill,Arapahoe,1205 S Havana St Unit B1,1,2,3,53
Chipotle Mexican Grill,Arapahoe,12073 E Arapahoe Rd,0,1,1,55
Chipotle Mexican Grill,Arapahoe,15280 E Iliff Ave,0,2,2,54
Chipotle Mexican Grill,Arapahoe,2300 S Parker Rd Unit B,0,3,3,53
Chipotle Mexican Grill,Arapahoe,333 W Hampden Ave Lbby 110,0,1,1,55
Chipotle Mexican Grill,Arapahoe,4205 S Buckley Rd,2,5,7,49
Chipotle Mexican Grill,Arapahoe,5699 S Broadway,3,0,3,53
Chipotle Mexican Grill,Arapahoe,6570 S Yosemite St Unit D,0,0,0,56
Chipotle Mexican Grill,Arapahoe,7515 S University Blvd,1,1,2,54
Chipotle Mexican Grill,Arapahoe,8000 E Belleview Ave Unit F20,0,0,0,56
Chipotle Mexican Grill,Douglas,18701 E Mainstreet,0,0,0,56
Chipotle Mexican Grill,Douglas,2209 W Wildcat Reserve Pkwy,0,5,5,51
Chipotle Mexican Grill,Douglas,5642 Allen Way Ste 104,1,1,2,54
Chipotle Mexican Grill,Douglas,8515 Park Meadows Center Dr Unit 3001,0,2,2,54
Chipotle Mexican Grill,Douglas,9500 Heritage Hills Cir Ste 700,2,3,5,51
Chipotle Mexican Grill 1291,Arapahoe,6710 S Cornerstar Way Unit A,1,3,4,52
Chipotle Mexican Grill 162,Adams,5988 Dahlia St,1,0,1,55
Chipotle Mexican Grill 1885,Arapahoe,8255 S Chester St Unit 100,2,4,6,50
Chipotle Mexican Grill 3245,Adams,14452 Orchard Pkwy Ste 300,1,0,1,55
Chipotle Mexican Grill 3376,Douglas,9579 S University Blvd,0,0,0,56
Chipotle Mexican Grill 566,Arapahoe,20209 E Smoky Hill Rd,1,2,3,53
Chipotle Mexican Grill 69,Adams,10320 Federal Blvd Unit 100,3,0,3,53
Chipotle Mexican Grill 712,Adams,815 Thornton Pkwy,1,1,2,54
Chipotle Mexican Grill 719,Douglas,18320 Cottonwood Dr Unit A,3,1,4,52
Chipotle Mexican Grill 745,Arapahoe,13700 E Colfax Ave Ste A,0,1,1,55
Chipotle Mexican Grill 943,Arapahoe,24100 E Commons Ave Ste 101,1,2,3,53
Chipotle Mexican Grill Inc,Adams,7303 N Federal Blvd Unit 1,0,1,1,55
Chocklo,Arapahoe,6830 S Yosemite St,5,2,7,49
Chop Shop Casual Urban Eatery,Arapahoe,3150 S Broadway,4,0,4,52
ChowSun,Arapahoe,830 S Buckley Rd,8,4,12,44
Chubbys,Adams,3004 W 105th Ave,4,4,8,48
Chubbys,Adams,7310 Federal Blvd,2,4,6,50
Chubbys,Adams,8330 Washington St,6,6,12,44
Chubbys 14,Arapahoe,5826 S Lowell Blvd,6,3,9,47
Chuck E Cheeses,Arapahoe,1001 W Hampden Ave,5,0,5,51
Chuck E Cheeses,Arapahoe,14005 E Exposition Ave,5,2,7,49
Chuck E Cheeses,Douglas,7510 Parkway Dr,2,4,6,50
Chuey Fus,Arapahoe,2950 S Broadway Unit B,3,3,6,50
Churchs Chicken,Adams,8661 Washington St,1,4,5,51
Churchs Chicken,Arapahoe,11900 E Colfax Ave,1,3,4,52
Churchs Chicken,Arapahoe,2181 S Havana St,0,2,2,54
Churchs Fried Chicken,Adams,7295 E 64th Ave,1,2,3,53
Chutney,Arapahoe,2740 S Havana St Unit K,6,6,12,44
Chuys,Arapahoe,8121 E Arapahoe Rd,4,0,4,52
Chuze Fitness,Douglas,9449 S University Blvd,0,0,0,56
Chuze Fitness - Englewood,Arapahoe,200 W Belleview Ave,1,3,4,52
Ciancios at Hyland Hills,Adams,9650 Sheridan Blvd,4,2,6,50
Cicis Pizza,Arapahoe,14000 E Mississippi Ave,2,4,6,50
Cielo at Castle Pines,Douglas,485 W Happy Canyon Rd,0,1,1,55
Cimarron Elementary,Arapahoe,17373 E Lehigh Pl,0,1,1,55
Cimarron Middle School,Douglas,12130 Canterberry Pkwy,0,3,3,53
Cinna Box Bakery and Cafe,Adams,2145 E 120th Ave Unit A,3,1,4,52
Cinnabon,Arapahoe,14200 E Alameda Ave,1,2,3,53
Cinzzettis Italian Market Restaurant,Adams,281 W 104th Ave,5,8,13,43
Circle K 2709844,Adams,4020 E 104th Ave,3,3,6,50
Circle K 2709845,Arapahoe,10553 E Briarwood Cir,2,8,10,46
Circle K 2709850,Adams,12801 Washington St,2,1,3,53
Circle K 2709852,Arapahoe,15291 E Hampden Ave,2,4,6,50
Circle K 2709853,Arapahoe,15593 E Iliff Ave,1,5,6,50
Circle K 2709860,Douglas,23 W Wolfensberger Rd,1,7,8,48
Circle K 2709862,Adams,290 W 104th Ave,2,1,3,53
Circle K 2709864,Arapahoe,298 S Potomac St,1,3,4,52
Circle K 2709876,Arapahoe,5095 S Federal Blvd,2,6,8,48
Circle K 2709878,Arapahoe,7425 E Arapahoe Rd,1,0,1,55
Circle K 2709879,Arapahoe,7550 S University Blvd,1,2,3,53
Circle K 2709880,Arapahoe,7701 E Orchard Rd,2,0,2,54
Circle K 2709883,Adams,8815 Federal Blvd,2,3,5,51
Circle K 2709892,Douglas,8663 S Quebec St,3,2,5,51
Circle K 2709898,Arapahoe,2200 W Evans Ave,5,1,6,50
Circle K 2709899,Arapahoe,2290 S Havana St,3,0,3,53
Circle K 2740623,Adams,9202 Huron St,6,2,8,48
Circle K 2740648,Adams,8290 Washington St,0,0,0,56
Circle K 2740666,Douglas,94 Wolfensberger Rd,1,6,7,49
Circle K 2740691,Arapahoe,2010 W Evans Ave,4,1,5,51
Circle K 2740696,Arapahoe,2190 S Peoria St,2,4,6,50
Circle K 2741115,Adams,11195 Huron St,2,2,4,52
Circle K 2741116,Adams,3540 W 92nd Ave,1,0,1,55
Circle K 2741120,Adams,385 E Bromley Ln,1,4,5,51
Circle K 2741126,Douglas,13185 S Parker Rd,2,5,7,49
Circle K 2741139,Adams,301 E 120th Ave,1,1,2,54
Circle K 2741157,Douglas,9701 S Parker Rd,0,2,2,54
Circle K 2741159,Douglas,34 Centennial Blvd,1,2,3,53
Circle K 2741165,Adams,4500 E 74th Ave,1,2,3,53
Circle K 2741183,Adams,7584 Sheridan Blvd,0,1,1,55
Circle K 2741189,Douglas,9945 S Oswego St,1,3,4,52
Circle K 2744048,Arapahoe,12796 E Colfax Ave,2,0,2,54
Circle K 2744051,Adams,3790 Chambers Rd,3,0,3,53
Circle K 2744052,Arapahoe,3504 S Tower Rd,1,2,3,53
Circle K 2744059,Douglas,310 S Wilcox St,2,4,6,50
Circle K 2744094,Arapahoe,7607 E Iliff Ave,2,0,2,54
Circle K 2744095,Adams,5810 N Broadway,1,4,5,51
Circle K 2744098,Arapahoe,4596 S Broadway,2,1,3,53
Circle K 2744099,Arapahoe,7296 E Belleview Ave,3,2,5,51
Circle K 2744101,Adams,801 W 84th Ave,3,1,4,52
Circle K 2744118,Douglas,2020 E County Line Rd,1,1,2,54
Circle K 2744123,Arapahoe,1599 W Littleton Blvd,0,0,0,56
Circle K 2744127,Arapahoe,5171 E Arapahoe Rd,0,0,0,56
Circle K 2744137,Douglas,19302 E Plaza Dr,3,3,6,50
Circle K 2744144,Adams,8801 Washington St,1,0,1,55
Circle K 2744147,Adams,7285 Pecos St,0,1,1,55
Circle K 9869,Arapahoe,3694 W Bowles Ave,0,0,0,56
Circle K Store 2704585,Arapahoe,17001 Parkerhouse Rd,3,1,4,52
City Donuts,Arapahoe,5816 S Lowell Blvd,2,2,4,52
City Donuts,Arapahoe,746 Peoria St,6,6,12,44
Clara Metz Elementary,Adams,2341 Sherrelwood Dr,0,1,1,55
Clayton Elementary,Arapahoe,4600 S Fox St,1,0,1,55
Clayton Elementary,Arapahoe,475 W Union Ave,1,0,1,55
Clayton/Academy High Kitchen,Adams,8970 York St,3,1,4,52
Clear Sky Elementary,Douglas,1470 Clear Sky Way,0,0,0,56
Clearwater Cafe,Arapahoe,5800 S Powhaton Rd,1,1,2,54
Cleopatra Grill and Hummus,Adams,10250 Federal Blvd Unit 300,5,5,10,46
Clock Tower Grill,Douglas,9360 Station St Ste 100,3,5,8,48
Club at Ravenna Half Way House,Douglas,7694 Raphael Ln,0,3,3,53
Clyde Miller Elementary,Adams,1701 Espana St,1,0,1,55
CoBank Cafe,Arapahoe,6340 S Fiddlers Green Cir,2,4,6,50
Cochino Taco,Arapahoe,3495 S Downing St,7,5,12,44
Coco Pirata,Arapahoe,10600 E Iliff Ave,7,2,9,47
Code Poke,Douglas,1601 Mayberry Dr Ste 103,3,1,4,52
Codys Cafe and Bar,Arapahoe,10203 E Iliff Ave,5,2,7,49
Cold Stone Creamery,Adams,245 Pavilions Pl Unit A,1,3,4,52
Cold Stone Creamery,Arapahoe,14132 E Cedar Ave Unit A,2,2,4,52
Cold Stone Creamery,Arapahoe,23973 E Prospect Ave Unit A,0,0,0,56
Cold Stone Creamery,Arapahoe,697 W Hampden Ave,1,2,3,53
Cold Stone Creamery,Arapahoe,7301 S Santa Fe Dr Unit 110,2,7,9,47
Cold Stone Creamery,Douglas,312 Metzler Dr Unit A,0,0,0,56
Cold Stone Creamery,Douglas,8441 S Yosemite St Ste 5,3,5,8,48
Cold Stone Creamery 123,Douglas,17051 Lincoln Ave Unit L,1,1,2,54
Cold Stone Creamery 722,Douglas,9338 Dorchester St Unit A3,0,4,4,52
Colonnas Pizza,Douglas,11215 S Parker Rd Unit A,3,7,10,46
Colonnas Pizza and Pasta,Arapahoe,7475 E Arapahoe Rd Ste 6,1,2,3,53
Colorado Cork and Keg,Douglas,971 Park St,0,0,0,56
Colorado Early Colleges Aurora,Arapahoe,350 Blackhawk St,0,0,0,56
Colorado Early Colleges Douglas County,Douglas,10235 Park Glenn Way,0,0,0,56
Colorado Golf Club/ Main Bar Kitchen,Douglas,8000 Preservation Trl,2,9,11,45
Colorado Ranch Market Bakery,Adams,11505 E Colfax Ave,5,8,13,43
Colorado Singh Sabha,Adams,20555 E 120th Ave,5,8,13,43
Colorado Stem Academy,Adams,7281 Irving St,0,0,0,56
Colorado Taproom and Grill,Douglas,19539 Hess Rd Unit 101,1,1,2,54
Colorado Weddings,Adams,8301 Rosemary St,1,0,1,55
Colorados Finest Alternative High School,Arapahoe,300 W Chenango Ave,0,0,0,56
Coloradough Pizza,Arapahoe,15430 E Smoky Hill Rd,3,2,5,51
Coloradough Pizza,Arapahoe,17860 Cottonwood Dr,3,4,7,49
Coloradough Pizza,Arapahoe,8170 S University Blvd Ste 110,2,0,2,54
Colore Italian Restaurant and Pizzeria,Arapahoe,2700 S Broadway Unit A,5,3,8,48
Columbia Middle School,Arapahoe,17600 E Columbia Ave,0,2,2,54
Columbine Country Club Main Kitchen and Dinning Areas,Arapahoe,17 Fairway Ln,2,4,6,50
Comcast Cafe,Arapahoe,9401 E Panorama Cir,5,6,11,45
Comcast Call Center,Arapahoe,8000 E Iliff Ave,3,6,9,47
Comedy Works South,Arapahoe,5345 Landmark Pl Ste 101,11,7,18,38
Comfort Inn,Adams,401 E 58th Ave,3,5,8,48
Comfort Inn & Suites,Adams,2180 S Medical Center Dr,2,6,8,48
Comfort Suites,Arapahoe,7374 S Clinton St,4,4,8,48
Comfort Suites,Douglas,4755 Castleton Way,9,7,16,40
Comfort Suites Denver South,Douglas,7060 E County Line Rd,1,1,2,54
Comida Cantina,Adams,2501 Dallas St,4,6,10,46
Comitis Crisis Center/ Kitchen,Adams,2178 Victor St,3,3,6,50
Common Grounds Golf Course,Arapahoe,10300 E Golfers Way,1,1,2,54
Community Leadership Academy,Adams,6880 Holly St,0,1,1,55
Community Reach Center Margaret Carpenter Center,Adams,8801 Lipan St,2,2,4,52
Compark Convenience,Arapahoe,15305 Compark Blvd,2,0,2,54
Conoco,Adams,1202 E 58th Ave Unit A,6,5,11,45
Conoco,Adams,3151 Airport Blvd,2,0,2,54
Conoco Gas Station,Adams,33105 E Colfax Ave Ste A,5,7,12,44
Cook Creek Pool/ Concession,Douglas,8711 Lone Tree Pkwy,1,3,4,52
Cookies and Crema,Douglas,4284 Trail Boss Dr Ste 100,5,7,12,44
Cooking Crane The,Adams,12189 Pennsylvania St,3,2,5,51
Copper Mesa Elementary,Douglas,3501 Poston Pkwy,0,2,2,54
Copper Pot on Broadway The,Arapahoe,2796 S Broadway,10,11,21,35
Copper Rail Bar and Grill,Adams,174 S Main St,4,8,12,44
Corafayes Cafe,Adams,16251 E Colfax Ave,9,13,22,34
Core Civic,Arapahoe,14485 E Fremont Ave,2,2,4,52
Core Civic - Arapahoe Community Treatment Center,Arapahoe,3265 W Girard Ave,4,1,5,51
Corner Bakery Cafe,Arapahoe,2253 E Briarwood Ave Unit B5,1,3,4,52
Corner Bakery Cafe,Douglas,1601 Mayberry Dr Ste 102,3,7,10,46
Corner Market,Adams,6140 Federal Blvd,1,0,1,55
Corner Market,Douglas,9181 Spruce Mountain Rd,1,6,7,49
Corner Poke,Arapahoe,4666 S Yosemite St,2,0,2,54
Coronado Hills Elementary,Adams,8300 Downing Dr,0,0,0,56
Coronados Mexican Food,Adams,7940 Sheridan Blvd,2,2,4,52
Coronas Mexican Grill,Adams,56171 E Colfax Ave Unit 2,5,5,10,46
Costa Vida,Adams,14316 Orchard Pkwy Ste 100,8,6,14,42
Costa Vida,Arapahoe,23870 E Smoky Hill Rd Unit 30,3,0,3,53
Costa Vida Lone Tree,Douglas,10005 Commons St Ste 280,5,6,11,45
Costco Wholesale 1022,Douglas,18414 Cottonwood Dr,4,2,6,50
Costco Wholesale 1027,Arapahoe,4000 River Point Pkwy,1,1,2,54
Costco Wholesale 439,Arapahoe,1471 S Havana St,1,0,1,55
Costco Wholesale 468,Douglas,8686 Park Meadows Center Dr,2,2,4,52
Costco Wholesale 629,Adams,16375 Washington St,2,6,8,48
Cotton Creek Elementary,Adams,11100 Vrain St,0,0,0,56
Cottonwood Creek School,Arapahoe,11200 E Orchard Rd,0,0,0,56
Cougar Run Elementary School,Douglas,8780 Venneford Ranch Rd,0,0,0,56
Country Club at Castle Pines,Douglas,6400 Country Club Dr,4,10,14,42
Country Pride,Adams,5101 Quebec St,2,4,6,50
Courtside Cafe,Douglas,374 Inverness Pkwy,6,7,13,43
Courtyard By Marriott,Adams,14355 Orchard Pkwy,2,4,6,50
Courtyard by Marriott,Douglas,3056 W County Line Rd,1,0,1,55
Courtyard by Marriott,Douglas,8320 S Valley Hwy,5,8,13,43
Cowboy Up,Arapahoe,15821 E Centretech Cir,1,1,2,54
Coyote Creek Elementary,Douglas,2861 Baneberry Ct,1,0,1,55
Coyote Hills Elementary,Arapahoe,24605 E Davies Way,0,0,0,56
Cozy Cafe,Arapahoe,350 Havana St,2,3,5,51
Cracker Barrel Old County Store of Colorado,Adams,350 W 120th Ave,3,5,8,48
Craig Hospital,Arapahoe,3425 S Clarkson St,1,0,1,55
Cranellis - Restaurant,Douglas,10047 Park Meadows Dr Unit F,1,3,4,52
Crave Cafe,Douglas,3982 Limelight Ave Unit C,4,8,12,44
Crave Coffee Roasters,Arapahoe,5322 DTC Blvd Unit 200,4,2,6,50
Crave It Frozen Yogurt,Arapahoe,12201 E Arapahoe Rd Unit B9,0,1,1,55
Crave Real Burgers,Douglas,9344 Dorchester St # 101,7,8,15,41
Crawfish Boil Company,Arapahoe,6851 S Gaylord St Unit B251,0,1,1,55
Crazy Caterer,Arapahoe,15821 E Centretech Cir,1,1,2,54
Create Cooking School,Arapahoe,2501 Dallas St Ste 128,3,0,3,53
Creekside Elementary,Arapahoe,19993 E Long Ave,0,0,0,56
Cresthill Middle School,Douglas,9195 Cresthill Ln,0,0,0,56
Crisp Cafe,Arapahoe,5690 DTC Blvd,2,0,2,54
Crossroads School Satellite,Adams,10900 Huron St,0,0,0,56
Crowfoot Valley Coffee,Douglas,734 Wilcox St Ste 102,3,5,8,48
Crowfoot Valley Coffee at ACC,Douglas,4500 Limelight Ave,0,0,0,56
Crown Pointe Academy,Adams,2900 W 86th Ave,1,3,4,52
Crowne Plaza Denver Airport Convention Center,Adams,15500 E 40th Ave,5,6,11,45
Crumbl Arapahoe,Arapahoe,8547 E Arapahoe Rd Unit C,1,0,1,55
Crumbl Cookies,Adams,14332 N Lincoln St Ste H,2,1,3,53
Crumbl Cookies,Adams,2325 Prairie Center Pkwy Unit E,3,3,6,50
Crush Wine,Douglas,3911 Ambrosia St Unit 102,0,0,0,56
Crystal Island,Adams,3901 E 112th Ave Unit K,9,7,16,40
Cuba Bakery and Cafe,Arapahoe,15028 E Mississippi Ave,7,2,9,47
Cuba Cuba,Douglas,6375 Promenade Pkwy Unit 210,7,7,14,42
Cuba Cuba,Douglas,9567 S University Blvd Unit C1A,6,7,13,43
Cuba Cuba Sandwicheria,Adams,14312 Lincoln St,3,5,8,48
Cuba Cuba Sandwicheria,Arapahoe,5322 DTC Blvd Unit 400,1,1,2,54
Cuba Cuba Sandwicheria,Arapahoe,654 S Colorado Blvd,7,7,14,42
Cubs Q,Arapahoe,6955 S York St Ste 422,4,5,9,47
Culinary Group Caterers,Arapahoe,3480 S Broadway,1,2,3,53
Culinary Masters Catering,Arapahoe,499 S Elm St,2,0,2,54
Culvers,Adams,9790 N Washington St,4,4,8,48
Culvers,Arapahoe,10440 E Arapahoe Rd,2,4,6,50
Culvers,Arapahoe,7440 S Broadway,3,0,3,53
Culvers,Douglas,18561 E Mainstreet,1,2,3,53
Culvers,Douglas,654 Genoa Way,1,3,4,52
Curds Cheese,Arapahoe,2449 W Main St,7,2,9,47
D Lish Catering Inc,Adams,1850 E Egbert St,0,2,2,54
DCS Montessori Charter School,Douglas,311 E Castle Pines Pkwy,2,0,2,54
DMZ Pub,Arapahoe,2680 S Havana St Unit M,6,4,10,46
Dae Bak Goal Restaurant,Arapahoe,2648 S Parker Rd Unit 11,3,3,6,50
Dae Gee,Adams,7570 Sheridan Blvd,3,8,11,45
Dairy Queen,Adams,2564 E Bridge St,1,3,4,52
Dairy Queen,Arapahoe,2897 W Belleview Ave Unit A,3,6,9,47
Dairy Queen,Arapahoe,3140 S Parker Rd Unit 14,2,4,6,50
Dairy Queen 10062,Adams,774 W 120th Ave,3,6,9,47
Dairy Queen 10415,Arapahoe,8223 S Quebec St,1,2,3,53
Dairy Queen 14,Adams,721 W 84th Ave,1,2,3,53
Dairy Queen 22,Adams,7960 Sheridan Blvd,1,5,6,50
Dairy Queen 40948,Adams,10250 Federal Blvd Unit 200,3,6,9,47
Dairy Queen 42251,Arapahoe,24300 E Smoky Hill Rd Ste 102,1,1,2,54
Dairy Queen 47,Arapahoe,2197 S Chambers Rd,3,4,7,49
Dairy Queen 64,Douglas,9435 S University Blvd,3,4,7,49
Dairy Queen Grill and Chill,Adams,3701 Tower Rd,1,2,3,53
Dairy Queen Orange Julius 41908,Arapahoe,16270 E Arapahoe Rd Unit 206,1,1,2,54
Dairy Queen of Glendale,Arapahoe,780 S Colorado Blvd Unit A,1,0,1,55
Dakota Valley Elementary,Arapahoe,3950 S Kirk Way,0,0,0,56
Dalton Elementary,Arapahoe,17401 E Dartmouth Ave,0,0,0,56
Damascus Grill,Arapahoe,1399 W Littleton Blvd,8,7,15,41
Damascus Grill,Douglas,703 Wilcox St Ste E,6,10,16,40
Dancing Noodle,Douglas,10841 S Crossroads Dr # 10,6,8,14,42
Danielles,Douglas,872 W Happy Canyon Rd Ste 100,1,3,4,52
Daniels of Paris,Arapahoe,12253 E Iliff Ave Unit C,3,4,7,49
Dar Chocolate,Adams,12189 Pennsylvania St,1,0,1,55
Dartmouth Elementary,Arapahoe,3050 S Laredo St,0,0,0,56
Davies Locker,Adams,8845 Lowell Blvd,1,3,4,52
Daylight Cafe,Adams,3924 E 120th Ave,6,3,9,47
Daytona Mart,Arapahoe,1411 Dayton St,0,0,0,56
DazBog Coffee 37,Douglas,1811 Plaza Dr,2,3,5,51
Dazbog Coffee,Douglas,202 Wilcox St,0,2,2,54
De Lunas Panaderia Y Taqueria,Adams,7575 Broadway Unit F,5,8,13,43
Deckers Cafe and Coffee Shop,Douglas,8570 S Highway 67 Unit A,5,9,14,42
Deep Space,Douglas,11020 S Pikes Peak Dr Unit 50,0,2,2,54
Deer Trail 66,Arapahoe,555 7th Ave,1,3,4,52
Deer Trail School PK-12,Arapahoe,130 S 2nd Ave,1,1,2,54
Defy Thornton,Adams,9925 Grant St,1,1,2,54
Del Friscos Double Eagle Steak House,Arapahoe,8100 E Orchard Rd,3,2,5,51
Del Mar Family Aquatic Center,Arapahoe,12000 E 6th Ave,2,2,4,52
Del Taco 1002,Arapahoe,3465 Salida St,5,10,15,41
Del Taco 1043,Arapahoe,11155 E Arapahoe Pl,4,9,13,43
Del Taco 1047,Adams,18260 E 104th Ave,5,2,7,49
Del Taco 1086,Douglas,11147 Pikes Peak Dr,2,4,6,50
Del Taco 1237,Douglas,6865 Promenade Pkwy,8,11,19,37
Del Taco 738,Douglas,7506 Parkway Dr,4,2,6,50
Del Taco 778,Arapahoe,24023 E Prospect Ave,3,5,8,48
Del Taco 787,Arapahoe,50 W Belleview Ave,1,4,5,51
Del Taco 863,Adams,570 E Bromley Ln,4,4,8,48
Del Taco 864,Arapahoe,14400 E Colfax Ave,4,5,9,47
Delectable Catering,Arapahoe,4291 E Mississippi Ave,0,0,0,56
Delectable Egg,Adams,1005 W 120th Ave Ste 600,7,9,16,40
Delectable Egg,Arapahoe,5312 DTC Blvd Unit 100,6,0,6,50
Delfinas Sweets,Adams,15550 E 103rd Pl Ste 102,2,3,5,51
Deli Espresso,Arapahoe,8400 E Prentice Ave Unit 201,3,4,7,49
Delicias del Barrio,Arapahoe,3133 Peoria St Unit 202,14,3,17,39
Dellannos Italian Deli and Pizza,Arapahoe,6820 S Liverpool St Ste B,2,2,4,52
Denma Sushi Restaurant,Arapahoe,8283 S Akron St Ste 160,9,7,16,40
Dennys 6573,Arapahoe,275 W Hampden Ave,3,7,10,46
Dennys 8719,Adams,350 E 104th Ave,3,6,9,47
Dennys 8720,Adams,16751 E 32nd Ave,2,9,11,45
Dennys Restaurant,Arapahoe,14400 E 6th Ave,5,5,10,46
Dennys Restaurant,Arapahoe,1505 S Havana St,1,5,6,50
Denos Country Store,Adams,4000 E 100th Ave,1,1,2,54
Denver Airport Hilton Garden Inn,Adams,16475 E 40th Cir,3,4,7,49
Denver Biscuit Company,Adams,2501 S Dallas St Unit 150,4,3,7,49
Denver East Strasburg KOA Family BBQ,Arapahoe,1352 Monroe St,3,1,4,52
Denver Halal Mini Market Inc,Arapahoe,10200 E Mississippi Ave Unit D,1,0,1,55
Denver Natural Snacks,Arapahoe,15401 E Mississippi Ave Ste A,2,1,3,53
Denver Springs Hospital,Arapahoe,8835 American Way,0,0,0,56
Denver Tech Center Courtyard,Arapahoe,6565 S Boston St,3,1,4,52
Devour,Arapahoe,1400 S Abilene St Ste 100,1,1,2,54
Dickeys BBQ Pit,Adams,9740 Grant St Ste 105,3,2,5,51
Dickeys Barbecue Pit,Adams,29 N 42nd Ave,3,0,3,53
Dickeys Barbecue Pit,Arapahoe,10551 E Garden Dr,3,5,8,48
Dickeys Barbeque Pit,Arapahoe,10230 E Arapahoe Rd,8,8,16,40
Dickeys Barbeque Pit,Douglas,323 Metzler Dr Unit 101,9,9,18,38
Digital Globe Cafe,Adams,1300 W 120th Ave,3,4,7,49
Dions,Adams,15150 E 104th Ave,2,2,4,52
Dions,Arapahoe,25750 E Arapahoe Rd,3,2,5,51
Dish Inverness,Arapahoe,90 E Inverness Cir,1,4,5,51
Dish Riverfront,Arapahoe,5701 S Santa Fe Dr,5,7,12,44
DocoFroYo,Douglas,2812 N Highway 85 Bldg E,0,0,0,56
Dog Haus,Arapahoe,12023 E Arapahoe Rd,4,1,5,51
Dog and Pony Restaurant and Pub,Arapahoe,2340 S Chambers Rd,1,0,1,55
Dollar General,Adams,7400 Highway 2,0,0,0,56
Dollar General,Adams,8495 Pecos St,2,5,7,49
Dollar General 19435,Adams,5300 Sheridan Blvd,0,2,2,54
Dollar Tree #03614,Arapahoe,351 Englewood Pkwy,3,4,7,49
Dollar Tree #04348,Arapahoe,7500 University Blvd,0,0,0,56
Dollar Tree #3915,Arapahoe,171 W County Line Rd,0,0,0,56
Dollar Tree 03075,Adams,9151 Washington St,1,2,3,53
Dollar Tree 03144,Adams,10615 Melody Dr,0,1,1,55
Dollar Tree 03499,Adams,3290 W 72nd Ave,1,3,4,52
Dollar Tree 03819,Adams,2439 Prairie Center Pkwy,0,1,1,55
Dollar Tree 03886,Adams,6000 E 64th Ave,1,2,3,53
Dollar Tree 04005,Douglas,5650 Allen Way,1,1,2,54
Dollar Tree 04040,Adams,1201 E 120th St,0,0,0,56
Dollar Tree 04338,Douglas,11000 S Parker Rd,1,3,4,52
Dollar Tree 04424,Adams,14458 Delaware St,0,1,1,55
Dollar Tree 04899,Adams,1407 W 84th Ave,0,2,2,54
Dollar Tree 05094,Douglas,8575 S Quebec St,1,1,2,54
Dollar Tree 07339,Adams,9430 N Sheridan Blvd,2,1,3,53
Dollar Tree 07477,Adams,825 S Kuner Rd,0,0,0,56
Dominos,Adams,1407 W 84th Ave Ste D3B,3,4,7,49
Dominos,Arapahoe,4260 S Chambers Rd,0,0,0,56
Dominos,Arapahoe,8450 E Iliff Ave Unit 3,3,1,4,52
Dominos,Douglas,558 Castle Pines Pkwy Unit 81,1,2,3,53
Dominos 8661,Adams,13644 Orchard Pkwy Ste 500,1,0,1,55
Dominos Pizza,Adams,9592 Federal Blvd,1,5,6,50
Dominos Pizza,Arapahoe,550 E Colfax Ave,3,3,6,50
Dominos Pizza,Arapahoe,5698 S Himalaya St Unit A,2,0,2,54
Dominos Pizza,Douglas,695 Jerry St Ste 108,2,2,4,52
Dominos Pizza 6217,Arapahoe,15281 E Mississippi Ave,1,1,2,54
Dominos Pizza 6239,Adams,3941 E 120th Ave,1,2,3,53
Dominos Pizza 6246,Adams,5171 W 64th Ave,1,3,4,52
Dominos Pizza 6357,Adams,530 E Bromley Ln Unit 110,0,3,3,53
Dominos Pizza 8654,Arapahoe,22651 E Aurora Pkwy,1,1,2,54
Don Juans Mexican Grill,Arapahoe,3625 W Bowles Ave Unit 16,11,8,19,37
Donut House,Arapahoe,25791 E Smoky Hill Rd Ste 20,3,1,4,52
Donut House,Arapahoe,3124 S Parker Rd Unit B,2,7,9,47
Donut House,Arapahoe,360 S Chambers Rd,2,4,6,50
Donut House The,Douglas,558 E Castle Pines Pkwy Unit B3,2,3,5,51
Donut House The,Douglas,9807 S Parker Rd,3,2,5,51
Donut The,Arapahoe,5270 E Arapahoe Rd Unit G8,1,3,4,52
Dos Amigos,Douglas,745 Wilcox St,4,7,11,45
Double Tree Hotel,Adams,8773 Yates Dr,4,7,11,45
DoubleTree Denver Tech Center,Arapahoe,7801 E Orchard Rd,1,1,2,54
DoubleTree by Hilton,Adams,83 E 120th Ave,5,4,9,47
DoubleTree by Hilton Aurora,Arapahoe,13696 E Iliff Pl,3,4,7,49
Dough Dreamery,Douglas,19751 E Main Ste R7,2,1,3,53
Douglas County Fairgrounds/ Indoor Arena,Douglas,500 Fairgrounds Rd Bldg B,0,2,2,54
Douglas County Fairgrounds/ Kirk Hall,Douglas,500 Fairgrounds Rd Bldg K,0,2,2,54
Douglas County High School,Douglas,2842 Front St,2,2,4,52
Douglas County High School/ South Building,Douglas,2693 Front St,1,6,7,49
Douglas County Justice Center,Douglas,4000 Justice Way,1,4,5,51
Douglas County School Shea Stadium Concessions,Douglas,3270 Redstone Park Cir,1,1,2,54
Douglas H Buck Community Recreation Center,Arapahoe,2004 W Powers Ave,9,5,14,42
Dougs Day Diner,Arapahoe,15444 E Orchard Rd,3,2,5,51
Dougs Diner,Adams,4243 E 136th Ave Unit 300,4,6,10,46
Dougs Diner,Douglas,18595 Mainstreet Unit 140,3,3,6,50
Downhill Brewing,Douglas,18921 E Plaza Dr Ste 104,2,0,2,54
Downtown Dinners,Arapahoe,6905 S Broadway,5,1,6,50
Dozens Restaurant,Arapahoe,2180 S Havana St,1,4,5,51
Dr Proctors Lounge,Arapahoe,4201 E Mississippi Ave,2,1,3,53
Dragon Boat,Arapahoe,13697 E Iliff Ave Ste 10,10,9,19,37
Dream Dinners,Arapahoe,7286 S Yosemite St Ste 120,2,6,8,48
Dream Dinners,Douglas,10447 S Parker Rd,0,4,4,52
Dream Pastries Inc,Douglas,370 Perry St,4,7,11,45
Drunken Monkeys,Adams,7667 Washington St,1,0,1,55
Drury Inn and Suites,Arapahoe,9445 E Dry Creek Rd,4,5,9,47
Dry Creek Cafe atHQ,Arapahoe,9201 E Dry Creek Rd,1,1,2,54
Dry Creek Deli,Arapahoe,7348 S Alton Way Bldg 9,4,7,11,45
Dry Creek Elementary,Arapahoe,7686 E Hinsdale Ave,1,0,1,55
Dry Creek Gas N Snack,Arapahoe,8787 E Dry Creek Rd,3,3,6,50
Dubbs Pub,Arapahoe,5301 S Broadway,2,0,2,54
Duffer Haus,Arapahoe,3470 S Broadway,5,0,5,51
Duffeyroll Cafe,Arapahoe,5198 S Broadway,5,5,10,46
Dukes Restaurant and Saloon,Douglas,363 Village Square Ln,0,2,2,54
Dulce Neveria,Adams,7055 Pecos St,2,3,5,51
Dungeons and Donuts,Arapahoe,6902 S Vine St Unit B,0,0,0,56
Dunkin Donuts 352462,Arapahoe,9595 E Arapahoe Rd Unit A,2,1,3,53
Dunkin Donuts 855,Adams,8775 Washington St,1,4,5,51
Dunkin Donuts 859,Adams,13591 N Huron St,1,0,1,55
Dunkin Donuts Baskin Robbins,Arapahoe,16401 E Arapahoe Rd Unit C,3,2,5,51
Dupont Elementary,Adams,7970 Kimberly St,0,0,0,56
Dutch Bros Coffee,Adams,41 W 84th,3,5,8,48
Dutch Bros Coffee,Arapahoe,14505 E Arapahoe Rd,1,0,1,55
ED Care,Arapahoe,4100 E Mississippi Ave Unit 1300,0,1,1,55
Eagle Ridge Academy,Adams,3551 E Southern St,0,1,1,55
Eagle Ridge Elementary School,Douglas,7716 Timberline Rd,0,1,1,55
Eagle View Elementary,Adams,4601 Summit Grove Pkwy,1,0,1,55
Eaglecrest High School,Arapahoe,5100 S Piccadilly St,1,0,1,55
Eagles Fraternal Order 3226,Adams,8651 Huron St,2,8,10,46
Earls,Douglas,8335 Park Meadows Center Dr,9,10,19,37
Early Bird Restaurant,Adams,11940 Bradburn Blvd Unit 400,7,7,14,42
Early Bird Restaurant,Arapahoe,5425 Landmark Pl,6,3,9,47
Early College of Arvada,Adams,4905 W 60th Ave,0,0,0,56
East Cafe,Arapahoe,15140 E Mississippi Ave,6,2,8,48
East China,Arapahoe,15510 E Centretech Pkwy,6,4,10,46
East Dynasty Restaurant,Arapahoe,22942 E Smoky Hill Rd,3,2,5,51
East Elementary,Arapahoe,5933 S Fairfield St,1,2,3,53
East Middle School,Arapahoe,1275 Fraser St,0,3,3,53
East Moon Asian Bistro and Sushi Bar,Arapahoe,8162 S Holly St,3,2,5,51
East Side Kosher Deli,Arapahoe,499 S Elm St,0,5,5,51
Eastridge Elementary,Arapahoe,11777 E Wesley Ave,0,0,0,56
Ecclesia,Douglas,221 Perry St,1,1,2,54
Echo Park Stadium Concessions,Douglas,11901 Newlin Gulch Blvd,1,1,2,54
Eclectic Elegance Events,Adams,8990 York St,2,3,5,51
Eco Gas,Arapahoe,3480 S Logan St,0,0,0,56
Eddie Merlots,Arapahoe,10110 E Dry Creek Rd,5,5,10,46
Edible Arrangements,Adams,100 E 120th Ave Unit G130,2,0,2,54
Edible Arrangements 503,Arapahoe,17856 Cottonwood Dr,1,1,2,54
Edo Higan,Douglas,8439 Park Meadows Center Dr Unit I 550,3,1,4,52
Egg Roll King,Douglas,7142 E County Line Rd,5,3,8,48
Egg The,Douglas,8800 S Colorado Blvd Unit B,5,4,9,47
Egg and I,Douglas,18901 E Mainstreet Unit A,4,3,7,49
Eggroll King East,Arapahoe,4217 S Buckley Rd,6,10,16,40
Einstein Bros Bagels 1240,Douglas,9385 S Colorado Blvd Unit 110,1,3,4,52
Einstein Bros Bagels 1402,Arapahoe,4090 S Parker Rd Unit C,1,0,1,55
Einstein Bros Bagels 1847,Arapahoe,4920 S Yosemite St Unit C4,1,3,4,52
Einstein Bros Bagels 2227,Adams,5180 W 120th Ave,2,6,8,48
Einstein Bros Bagels 2632,Douglas,9249 S Broadway # 700,2,5,7,49
Einstein Bros Bagels 2646,Arapahoe,6650 S Yosemite St Unit 10501,1,1,2,54
Einstein Bros Bagels 3346,Arapahoe,12073 E Arapahoe Rd Unit 100,0,1,1,55
Einstein Bros Bagels 3350,Adams,16495 E 40th Cir,2,4,6,50
Einstein Bros Bagels 3554,Arapahoe,6232 S Parker Rd Unit 400,2,3,5,51
Einstein Bros Bagels 3589,Arapahoe,18191 E Hampden Ave Unit A,2,3,5,51
Einstein Bros Bagels 3598,Arapahoe,697 W Hampden Ave Unit 104,5,3,8,48
Einstein Bros Bagels 3605,Douglas,3993 Limelight Ave Unit A,2,4,6,50
Einstein Bros Bagels 925,Arapahoe,7523 S University Blvd,1,3,4,52
El Aguila,Adams,6970 Highway 2,4,0,4,52
El Angel Restaurant,Adams,3133 Peoria St Unit 209,10,11,21,35
El Autentico Mexican Restaurant,Adams,5880 Broadway,3,3,6,50
El Azteca Mexican Food,Adams,2683 E 120th Ave Unit A3,8,10,18,38
El Berrinches Mexican,Adams,7850 Sheridan Blvd,3,4,7,49
El Bombon Nieves Crepas Y Algo Mas,Arapahoe,1082 Havana St,5,6,11,45
El Camaron Loco,Adams,218 N Main St,9,5,14,42
El Camaron Loco,Adams,6740 E 72nd Ave,7,8,15,41
El Camaron Loco,Arapahoe,513 Havana St,8,8,16,40
El Cameron Loco,Adams,619 W 84th Ave,4,7,11,45
El Camino,Adams,15355 E Colfax Ave Unit G1,6,4,10,46
El Canton Cantina,Adams,7052 Pecos St,4,2,6,50
El Carboncito,Arapahoe,15210 E 6th Ave,7,13,20,36
El Charro Market,Adams,6155 E 72nd Ave,7,5,12,44
El Chubbys,Arapahoe,1191 S Abilene St,5,2,7,49
El Coco Pirata,Adams,5411 Quebec St,4,2,6,50
El Dorado Elementary,Douglas,1305 Timbervale Trl,0,0,0,56
El Dorado Event Center,Arapahoe,525 Sable Blvd,1,4,5,51
El Fogon Mexican Restaurant,Adams,621 W 84th Ave,2,8,10,46
El Gordo Taqueria,Adams,1714 W 72nd Ave,2,3,5,51
El Jakalito Market,Arapahoe,15401 E Mississippi Ave,7,6,13,43
El Jakalito Market 2,Arapahoe,12203 E Iliff Ave Ste F,9,6,15,41
El Jardin Restaurant,Adams,6460 E 73rd Ave,2,4,6,50
El Jaripeo,Arapahoe,1050 S Havana St,4,4,8,48
El Karajo Mexican Restaurant,Arapahoe,6600 S Quebec St Ste A,6,7,13,43
El Korita Restaurant,Douglas,106 Wilcox St,3,7,10,46
El Lucerito Jr,Adams,3751 Tower Rd Ste A,6,8,14,42
El Lucero Mexican Restaurant,Arapahoe,1500 W Littleton Blvd Unit 103,5,3,8,48
El Mercado de Colorado,Adams,11505 E Colfax Ave Unit C,11,7,18,38
El Meson,Douglas,794 S Perry St,4,5,9,47
El Meson Mexican Restaurant,Douglas,3506 Town Center Dr Unit A,3,4,7,49
El Mirador,Adams,11370 Huron St,8,9,17,39
El Muchacho Alegre,Adams,3113 N Peoria St Unit E,9,3,12,44
El Muelle,Arapahoe,475 Sable Blvd Unit F,1,3,4,52
El Original Nightclub,Adams,7069 Pecos St,1,4,5,51
El Paisa,Adams,9541 E Colfax Ave,4,1,5,51
El Palenque Bar,Adams,490 N Main St,9,5,14,42
El Parral Mexican Restaurant,Arapahoe,9261 E Arapahoe Rd,4,6,10,46
El Pollo Feliz,Adams,2415 E 88th Ave,14,3,17,39
El Puerto DeVeracruz,Adams,680 E 58th Ave,5,8,13,43
El Sabor Jerezano Restaurant,Adams,10639 Melody Dr,7,4,11,45
El Senor Sol 8,Arapahoe,6651 S University Blvd,5,3,8,48
El Taco Loco Mexican Restaurant,Adams,644 S Main St,10,10,20,36
El Taco Stop,Adams,6960 Highway 2,2,6,8,48
El Tamalero,Arapahoe,1124 Yosemite St Unit A,4,3,7,49
El Tapatio,Arapahoe,9281 E Arapahoe Rd,3,4,7,49
El Tepehuan Restaurant,Arapahoe,3495 S Broadway St,7,3,10,46
El Tequileno Family Mexican Restaurant,Arapahoe,2790 S Havana St Unit X1,8,6,14,42
El Torito 3,Arapahoe,4978 Leetsdale Dr,7,4,11,45
El Wherever Bar,Adams,5500 N Washington St,3,1,4,52
Element Denver - RFE,Douglas,9985 Park Meadows Dr,2,1,3,53
Elevated Gains,Adams,12189 Pennsylvania St,0,0,0,56
Elkhart Elementary,Arapahoe,1020 Eagle St,0,1,1,55
Ella Bliss Beauty Bar,Arapahoe,8575 E Arapahoe Rd Unit N,2,1,3,53
Ella Bliss Beauty Bar,Douglas,3624 E Highlands Ranch Pkwy,1,1,2,54
Elsie Malley Senior Center,Arapahoe,3380 S Lincoln St,0,0,0,56
Elvis Cinemas,Adams,5157 W 64th Ave,2,1,3,53
EmNet Organics,Arapahoe,4086 S Parker Rd,2,2,4,52
Embassy Suites Denver Tech Center,Arapahoe,10250 E Costilla Ave,9,8,17,39
Emerald City Smoothie,Arapahoe,760 S Colorado Blvd Ste F,2,4,6,50
Emerald Isle,Arapahoe,4385 S Parker Rd,2,1,3,53
En El Puerto Vallarta,Adams,9538 Montview Blvd,8,9,17,39
Enchanted Grounds,Arapahoe,3615 W Bowles Ave Unit 6,3,3,6,50
Encore,Arapahoe,3139 S Broadway,0,2,2,54
Endeavor Academy,Arapahoe,14076 E Briarwood Ave,0,0,0,56
Englewood Grand,Arapahoe,3435 S Broadway,3,2,5,51
Englewood High School Football Concessions,Arapahoe,3800 S Logan St,2,0,2,54
Englewood Lodge BPOE 2122,Arapahoe,3690 S Jason St,3,1,4,52
Englewood Tavern,Arapahoe,4386 S Broadway,2,1,3,53
English Tealeaves,Douglas,18551 E Mainstreet Ste 1A,3,0,3,53
Epicurean Catering,Arapahoe,6800 S Xanthia St,3,2,5,51
Etais,Adams,101 E 70th Ave,2,3,5,51
Etais Bakery Cafe,Adams,13001 E 17th Pl,4,3,7,49
Etais Bakery Cafe Fiddlers Green,Arapahoe,6400 S Fiddlers Green Cir Ste 150,2,1,3,53
Etais Bakery Cafe at Anschutz,Adams,12700 E 19th Ave Bldg P51,7,5,12,44
Etais Bakery Cafe on Broadway,Adams,101 E 70th Ave,3,3,6,50
Euclid Middle School,Arapahoe,777 W Euclid Ave,0,0,0,56
Eurest Century Link Littleton,Arapahoe,700 W Mineral Ave,2,0,2,54
Eurest Dining,Arapahoe,333 Inverness Dr S,5,7,12,44
Eurest Dining Services,Arapahoe,16430 E Hughes Dr,0,2,2,54
Eurest Dining Services,Arapahoe,55 Inverness Dr E,3,6,9,47
Eurest Dining Services,Douglas,15 Inverness Way E,2,5,7,49
Eurest at DirecTV,Arapahoe,161 Inverness Dr W,3,6,9,47
Eurest at US Bank,Arapahoe,7459 S Lima St,4,5,9,47
Eurest at Visa Everywhere Lounge,Douglas,8744 Lucent Blvd 4 Fl D4,0,0,0,56
EurestatCharter,Arapahoe,6350 S Fiddlers Green Cir,1,0,1,55
Europa,Arapahoe,13728 E Quincy Ave,4,3,7,49
European Market,Adams,10699 Melody Dr,4,0,4,52
Everyday 5717,Douglas,17840 Cottonwood Dr,1,1,2,54
Everyday Store,Adams,7990 Federal Blvd,1,3,4,52
Everyday Stores LLC,Douglas,10610 Longs Way,1,3,4,52
Exo tikka Inc,Douglas,9447 Park Meadows Dr Unit A,5,2,7,49
Explore Elementary,Adams,2410 Poze Blvd,0,1,1,55
Extra Point Bar and Grill,Adams,4050 E 100th Ave Unit A,11,6,17,39
Faifo,Adams,5055 W 72nd Ave,5,5,10,46
Fairfield Inn & Suites,Adams,948 Platte River Blvd,0,2,2,54
Fairfield Inn and Suites,Arapahoe,13851 E Harvard Ave,0,1,1,55
Fairfield Inn and Suites DTC South,Arapahoe,7056 E County Line Rd,1,3,4,52
Fairfield Inn and Suites by Marriot,Arapahoe,24192 E Prospect Ave,1,0,1,55
Fairview Elementary/ Sat,Adams,7826 Fairview Ave,0,3,3,53
Falcon Creek Middle School,Arapahoe,6100 S Genoa St,0,1,1,55
Family Dollar 22656,Adams,7067 Pecos St,1,1,2,54
Family Dollar 25457,Adams,2010 W 92nd Ave,0,3,3,53
Family Dollar 26699,Adams,1750 E 112th Ave,1,0,1,55
Family Dollar 27094,Adams,1511 E Bridge St,0,1,1,55
Family Dollar 28702,Adams,9410 Federal Blvd,0,2,2,54
Family Dollar 30671,Adams,10360 Colorado Blvd,2,2,4,52
Family Dollar 32173,Adams,636 W 84th Ave,0,0,0,56
Family Dollar 9094,Adams,5947 E 64TH Ave,1,0,1,55
Family Dollar Store,Arapahoe,1500 W Littleton Blvd,0,1,1,55
Family Dollar Store 3285,Adams,831 E 88th Ave,2,3,5,51
Family Dollar Store 6174,Adams,6071 E 72nd Ave,0,1,1,55
Family Tree House of Hope,Arapahoe,3301 S Grant St,3,2,5,51
Famous Daves,Arapahoe,15725 E Briarwood Cir,2,4,6,50
Famous Daves BBQ,Adams,16539 Washington St,5,4,9,47
Famous Wok,Arapahoe,14200 E Alameda Ave Unit 2073,4,3,7,49
Farmgirl Foods,Douglas,221 Perry St,1,1,2,54
Farro,Arapahoe,8230 S Holly St,3,2,5,51
Fast Market 8157,Adams,505 W 120th Ave,2,3,5,51
Fast Market Store 8158,Arapahoe,7799 E Arapahoe Rd,0,1,1,55
Fat Boys Bar and Grill,Arapahoe,10660 E Alameda Ave,5,5,10,46
Fat Shack,Adams,2665 E 120th Ave,4,8,12,44
Fat Shack,Arapahoe,1708 S Chambers Rd Unit 10,2,3,5,51
Fatburger,Arapahoe,14221 E Cedar Ave Unit A,1,3,4,52
Fazolis,Adams,460 E 120th Ave,4,8,12,44
Fazolis,Arapahoe,1012 S Abilene St,4,2,6,50
Federal Heights Elementary,Adams,2500 W 96th Ave,0,0,0,56
Feedery The,Arapahoe,900 E Hampden Ave,7,1,8,48
Felt,Arapahoe,101 W Floyd Ave,7,8,15,41
Fiddlers Green Amphitheater - South Plaza,Arapahoe,6350 Greenwood Plaza Blvd,0,5,5,51
Fiddlers Green VIP Bar,Arapahoe,6350 Greenwood Plaza Blvd,0,1,1,55
Field Elementary,Arapahoe,5402 S Sherman Way,1,0,1,55
Finn Mc Cools Bar and Grill,Arapahoe,8880 E Arapahoe Rd,7,8,15,41
Fire Bowl Cafe,Arapahoe,11435 E Briarwood Ave Ste 900,4,6,10,46
Firehouse Subs,Adams,10060 Grant St,1,5,6,50
Firehouse Subs,Arapahoe,13650 E Colfax Ave Unit F,3,1,4,52
Firehouse Subs,Arapahoe,2250 S Parker Rd Ste 140,1,3,4,52
Firehouse Subs,Arapahoe,9445 E County Line Rd Unit B,3,6,9,47
Firehouse Subs,Douglas,11280 S Twenty Mile Rd Ste 102,3,3,6,50
Firehouse Subs,Douglas,3993 Limelight Ave,2,4,6,50
Firehouse Subs,Douglas,9559 S University Blvd Unit 108,1,1,2,54
Firehouse Subs,Douglas,9992 Commons St Ste 120,2,2,4,52
Firehouse Subs 1009,Arapahoe,15405 E Briarwood Cir Unit B,3,4,7,49
Firehouse Subs 995,Adams,3425 Salida St Ste B,7,9,16,40
Fireside,Douglas,3235 Mill Vista Rd,1,4,5,51
First Data,Arapahoe,5775 DTC Blvd,0,0,0,56
First Watch,Arapahoe,2406 S Parker Rd Ste A,2,1,3,53
First Watch Cafe,Adams,100 E 120th Ave Unit G140,3,6,9,47
First Watch Restaurant 324,Arapahoe,6890 S University Blvd Ste 20,2,0,2,54
First Watch Restaurant 436,Douglas,9344 Dorchester St,3,2,5,51
Fish and Company,Douglas,221 Perry St,0,1,1,55
Fit Kitchen 1,Arapahoe,901 W Hampden Ave,4,3,7,49
Five Guys Burgers,Adams,14326 Lincoln St,1,2,3,53
Five Guys Burgers and Fries,Arapahoe,2300 S Parker Rd Unit D,1,1,2,54
Five Guys Burgers and Fries,Arapahoe,23963 E Prospect Ave Unit H,1,2,3,53
Five Guys Burgers and Fries,Arapahoe,3751 Tower Rd Unit H,1,2,3,53
Five Guys Burgers and Fries,Arapahoe,4989 S Broadway Unit,1,0,1,55
Five Guys Burgers and Fries,Arapahoe,6710 S Cornerstar Way Unit C,0,0,0,56
Five Guys Burgers and Fries,Arapahoe,8547 E Arapahoe Rd Unit A,2,0,2,54
Five Guys Burgers and Fries,Douglas,34 E Allen St Ste 100,1,1,2,54
Five Guys Burgers and Fries,Douglas,9352 S Colorado Blvd,0,0,0,56
Five Guys Burgers and Fries,Douglas,9992 Commons St Ste 130,0,1,1,55
Five Star Stadium Concession Stand,Adams,9360 Washington Ave,1,2,3,53
Flagstone Elementary,Douglas,104 Lovington St,0,0,0,56
Flaming Joes,Arapahoe,18648 E Hampden Ave,1,0,1,55
Flavor of Havana Cigar Bar and Cocktail Lounge,Arapahoe,2295 S Chambers Rd Unit F,1,2,3,53
Flemings Prime Steak House,Arapahoe,191 Inverness Dr W,3,5,8,48
Floodstage Ale Works,Adams,170 S Main St,5,4,9,47
Fly N B Cafe,Douglas,3235 Mill Vista Rd,1,7,8,48
Flying Horse Catering,Douglas,703 Wilcox St,1,4,5,51
Fogo de Chao Churrascaria,Douglas,8419 Park Meadows Center Dr,4,7,11,45
Fondita Del Norte,Adams,7174 Washington St Unit B,5,2,7,49
Fontana Sushi,Arapahoe,19741 E Smoky Hill Rd Unit B,4,2,6,50
Food and Drink Resources,Arapahoe,6555 S Kenton St Unit 302,0,0,0,56
Formosa Garden,Arapahoe,16645 E Smoky Hill Rd Unit F & G,4,9,13,43
Fortune Kitchen,Arapahoe,12120 E Mississippi Ave,3,7,10,46
Foundations Academy,Adams,340 S 45th Ave,1,0,1,55
Fourleaf Chopped Salads,Arapahoe,6840 S Dallas Way,5,13,18,38
Fox Creek Elementary,Douglas,6585 Collegiate Dr,0,0,0,56
Fox Hollow Elementary,Arapahoe,6363 S Waco St,0,0,0,56
Fox Ridge Middle School,Arapahoe,26301 E Arapahoe Rd,1,1,2,54
Fox and Hound Sports Tavern,Douglas,9239 Park Meadows Dr,5,6,11,45
Fracos,Arapahoe,5302 S Federal Cir Unit A,3,0,3,53
Francis M Day Elementary SAT,Adams,1740 Jordan Dr,0,1,1,55
Francys Gourmet,Arapahoe,10111 Inverness Main St Unit M,11,7,18,38
Frank the Pizza King,Arapahoe,4701 S Broadway,5,4,9,47
Franklin Elementary,Arapahoe,1603 E Euclid Ave,0,0,0,56
Franktown Elementary,Douglas,1384 N Highway 83,0,3,3,53
Franktown Market,Douglas,1958 N Highway 83,1,2,3,53
Fraternal Order of Eagles 3224,Arapahoe,1151 S Galena St,4,3,7,49
Fraternal Order of Eagles 3365,Adams,290 N 6th Ave,3,8,11,45
Fraternal Order of Eagles 3947,Douglas,1300 Caprice Dr,1,4,5,51
Fred Hanson Elementary,Adams,7133 E 73rd Ave,0,0,0,56
Freddys Frozen Custard,Douglas,900 Sgt Jon Stiles Dr,0,4,4,52
Freddys Frozen Custard & Steak Burgers,Adams,14255 Lincoln St,6,4,10,46
Freddys Frozen Custard & Steakburgers,Douglas,18424 Cottonwood Dr,2,0,2,54
Freddys Frozen Custard and Steakburger,Arapahoe,1103 S Iola St,3,4,7,49
Freddys Frozen Custard and Steakburger,Arapahoe,15705 E Briarwood Cir,1,2,3,53
Freddys Frozen Custard and Steakburger,Arapahoe,2660 W Belleview Ave,3,0,3,53
Freddys Frozen Custard and Steakburger,Douglas,1346 New Beale St,1,6,7,49
Freddys Frozen Custard and Steakburgers,Douglas,11140 S Twenty Mile Rd,3,2,5,51
Freds Breakfast Burritos,Adams,130 W 70th Ave,3,2,5,51
French Press,Arapahoe,4668 S Yosemite St,7,2,9,47
French Press The,Arapahoe,15290 E Iliff Ave,3,7,10,46
Freshies,Arapahoe,6902 S Vine St Unit A,0,0,0,56
Friar Tucks,Douglas,650 Perry Park Rd,0,0,0,56
Friendly Shell,Adams,9201 Huron St,0,2,2,54
Fritangas Mexican Restaurant,Arapahoe,15099 E Hampden Ave,3,5,8,48
Frolic Brewing Company,Adams,12910 Zuni St Unit 1300,4,5,9,47
Frontier Valley Elementary,Douglas,23919 E Canterberry Pkwy,0,0,0,56
Froth Centennial,Arapahoe,14200 E Arapahoe Rd,2,2,4,52
Froth Espresso Cafe,Arapahoe,1501 S Potomac St,1,1,2,54
Froyo Denver,Douglas,10000 Bellwether Ln,0,1,1,55
Fu Shing Chinese Restaurant,Adams,1024 W 104th Ave,4,5,9,47
FuNuGyz,Douglas,17904 Cottonwood Dr,2,4,6,50
Fuji San Sams Club,Arapahoe,6201 S Aurora Pkwy,1,2,3,53
Fuji San Sushi,Douglas,5940 Promenade Pkwy,0,1,1,55
Fujisan,Douglas,7817 Park Meadows Dr,0,0,0,56
Fujisan Sushi,Adams,9601 Grant St,3,0,3,53
Fujisan Sushi,Arapahoe,880 S Abilene St,0,1,1,55
Fujiyama Sushi and Hibachi,Douglas,1100 Sgt Jon Stiles Dr Unit 104,5,6,11,45
Full House Bar and Grill,Arapahoe,4272 S Broadway,6,7,13,43
Fulton Elementary,Arapahoe,755 Fulton St,0,3,3,53
Funny Plus,Arapahoe,2779 S Parker Rd,4,7,11,45
Futures Center,Adams,550 E 124th Ave,0,0,0,56
Fuzzy Taco,Arapahoe,16401 E Arapahoe Rd Unit A,1,1,2,54
Fuzzy Taco,Douglas,12231 Pine Bluffs Way Ste 101,2,2,4,52
Fuzzys Taco Shop,Adams,10280 Washington St,4,6,10,46
Fuzzys Taco Shop,Adams,4301 Main St Ste 100,4,5,9,47
Fuzzys Taco Shop,Arapahoe,7592 S University Blvd,2,4,6,50
Fuzzys Taco Shop,Douglas,5700 New Abbey Ln Unit D-330,2,2,4,52
G Ducks Bar and Grill,Arapahoe,15420 E Hampden Ave,1,1,2,54
GQUE BBQ and G Freeze,Douglas,8433 Park Meadows Center Dr Unit 143A,4,5,9,47
GQue Barbecue,Adams,5160 W 120th Ave Unit K,4,7,11,45
Gabriels,Douglas,5450 Manhart St,1,4,5,51
Game Train,Douglas,2690 E County Line Rd Ste E,2,0,2,54
Garbanzo Mediterranean Grill,Douglas,9996 Commons St Unit 310,5,5,10,46
Garbanzo Mediterranean Grill 1001,Arapahoe,8547 E Arapahoe Rd Unit D,0,2,2,54
Garbanzo Mediterranean Grill 1006,Arapahoe,630 S Colorado Blvd,3,3,6,50
Garbanzo Mediterranean Grill 1009,Arapahoe,8225 S Chester St Unit 101,5,6,11,45
Garden Bistro Kitchen,Adams,451 E 58th Ave,1,2,3,53
Garden View Cafe,Adams,12605 E 16th Ave Mail F770,2,1,3,53
Garibaldi Mexican Bistro,Arapahoe,3298 S Broadway Unit B,6,3,9,47
Garlic Jims Famous Gourmet Pizza,Douglas,3982 Red Cedar Dr Ste A,0,4,4,52
Garlic Knot Pizza,Arapahoe,1422 S Parker Rd Unit A144,4,4,8,48
Garlic Knot Pizza,Arapahoe,5120 E Arapahoe Rd Ste C2,4,3,7,49
Garlic Knot Pizza and Pasta,Arapahoe,1621 W Canal Cir Unit 100,7,4,11,45
Garlic Knot The,Adams,3995 E 120th Ave,10,7,17,39
Garlic Knot The,Arapahoe,1706 S Chambers Rd,6,6,12,44
Garnish Indian Fusion Cuisine,Arapahoe,6585 Greenwood Plaza Blvd,3,1,4,52
Gas Mart,Adams,1550 W 88th Ave Unit A,1,2,3,53
Gateway High School,Arapahoe,1300 S Sable Blvd,0,1,1,55
Gaylord of the Rockies - Pinyon Bar,Arapahoe,6700 N Gaylord Rockies Blvd,1,0,1,55
Ge-Jos Original,Arapahoe,7200 E Dry Creek Rd Unit R,3,1,4,52
Genghis Grill,Arapahoe,9617 E County Line Rd Unit B,3,3,6,50
Genji Ramen,Arapahoe,6853 S York St Unit 119,1,0,1,55
Georges Restaurant,Arapahoe,3454 S Broadway,5,7,12,44
Ghana International Market LLC,Arapahoe,495 Havana St,3,5,8,48
Gibbys Sports Saloon,Arapahoe,1555 S Havana St Unit W,0,3,3,53
Gigis Cupcakes,Arapahoe,7301 S Santa Fe Dr Unit 625,4,1,5,51
Glacier Homemade Ice Cream,Arapahoe,3455 S University Blvd Unit A,1,1,2,54
Glacier Ice Cream and Gelato,Arapahoe,4940 S Yosemite St Unit E1,2,0,2,54
Glacier Ice Cream and Gelato of CR,Douglas,115 N Wilcox St Unit 110,1,2,3,53
Glacier Peak Elementary,Adams,12060 Jasmine St,0,3,3,53
Glazed and Confuzed Donuts,Arapahoe,4660 S Yosemite St,0,0,0,56
Glenmoor Country Club/Main Level Kitchen,Arapahoe,110 Glenmoor Dr,3,0,3,53
Glenn Bar and Grill,Adams,11140 Irma Dr,4,7,11,45
Global Village Academy Douglas County,Douglas,18451 Ponderosa Dr,0,0,0,56
Global Village Academy Northglenn,Adams,555 W 112th Ave,3,1,4,52
Global Village Academy West Campus,Arapahoe,16401 E Alameda Dr,0,0,0,56
Gluten Escape,Arapahoe,7255 S Havana St Unit 110,1,2,3,53
Go Puff,Adams,3055 W 74th Ave Unit A,0,1,1,55
Go Puff,Arapahoe,7550A S Grant St,0,1,1,55
Goddard Middle School,Arapahoe,3800 W Berry Ave,0,4,4,52
Godfathers Pizza,Adams,227 N Main St,2,5,7,49
Gold Rush Elementary,Douglas,12021 S Swift Fox Way,2,4,6,50
Golden Corral Buffet and Grill,Adams,9751 Grant St,3,3,6,50
Golden Corral Buffet and Grill,Arapahoe,15775 E Arapahoe Rd,1,2,3,53
Golden Corral Buffet and Grill,Arapahoe,3677 S Santa Fe Dr,3,6,9,47
Golden Crust Pizza and Subs,Adams,5595 Pecos St Unit C,3,2,5,51
Golden Flame Hot Wings,Arapahoe,18757 E Hampden Ave Ste 156,4,5,9,47
Golden Flame Hot Wings,Douglas,16524 Keystone Blvd Ste D1,2,4,6,50
Golden Flame Hot Wings-Production Kitchen,Arapahoe,18757 E Hampden Unit 152,2,1,3,53
Golden Flames Hot Wings,Douglas,363 Village Square Ln Ste 145,1,7,8,48
Golden Saigon Vietnamese Restaurant,Arapahoe,2648 S Parker Rd Unit 3,1,5,6,50
Golden Scoop,Adams,536 Malley Dr,2,0,2,54
Golden Shanghai,Arapahoe,1412 S Parker Rd Unit A134,5,5,10,46
Golden Sky Sushi,Arapahoe,10180 E Colfax Ave Unit 184,2,0,2,54
Golden Town,Adams,5976 E 64th Ave,8,3,11,45
Golden Wok,Arapahoe,15280 E Hampden Ave,8,7,15,41
Golf 1st Deli and Coffee LLC,Arapahoe,10 S Havana St Ste 108,3,5,8,48
Golf Club at Bear Dance,Douglas,6630 Bear Dance Dr,4,7,11,45
Golf Club at Ravenna,Douglas,8250 Palladio Ct # A,3,3,6,50
Gomez Burritos,Adams,5520 Washington St,4,3,7,49
Good Times Burgers and Frozen Custard,Arapahoe,1220 S Buckley Rd,4,0,4,52
Good Times Burgers and Frozen Custard,Arapahoe,24093 E Prospect Ave,3,5,8,48
Good Times Burgers and Frozen Custard,Douglas,11305 S Parker Rd,3,6,9,47
Good Times Drive Thru Burgers,Adams,10450 Melody Dr,3,5,8,48
Good Times Drive Thru Burgers,Adams,16522 Washington St,3,1,4,52
Good Times Drive Thru Burgers,Adams,4003 E 120th Ave,3,6,9,47
Good Times Drive Thru Burgers,Adams,550 E Bromley Ln,5,9,14,42
Good Times Drive Thru Burgers,Arapahoe,16810 E Quincy Ave,4,5,9,47
Good Times Drive Thru Burgers,Arapahoe,6667 S Yosemite Ct,1,2,3,53
Good Times Drive Thru Burgers 117,Arapahoe,1105 S Havana St,2,7,9,47
Goodtimes Burgers,Douglas,9401 S University Blvd,1,1,2,54
Goodys Eatery,Adams,3010 W 72nd Ave,6,9,15,41
Gordibuena,Adams,7225 Monaco St,1,2,3,53
Gordos Mexican Restaurant,Adams,8101 Washington St,7,6,13,43
Gothic Theater,Arapahoe,3263 S Broadway,1,1,2,54
Gourmet Away,Arapahoe,14281 E Exposition Ave,2,3,5,51
Gourmet to Go,Arapahoe,3255 W Hampden Ave,2,3,5,51
GraceFull Cafe,Arapahoe,5610 S Curtice St,1,0,1,55
Grand Slam Snacks,Douglas,3280 Redstone Park Cir,0,0,0,56
Grande Station,Arapahoe,2299 W Main St,4,1,5,51
Grandmas Sweet Tooth,Adams,9656 Washington St,2,2,4,52
Grandview High School,Arapahoe,20500 E Arapahoe Rd,0,0,0,56
Granellis Pizzeria,Douglas,21 Wilcox St,5,6,11,45
Great Beginnings,Douglas,11800 E Oswego St Unit D70,4,7,11,45
Great Greek Mediterranean Grill,Adams,14315 Orchard Pkwy Ste 400,4,1,5,51
Great Hall of Abraxas,Adams,12004 Melody Dr,0,2,2,54
Great Harvest Bread Company,Arapahoe,5910 S University Blvd Unit A12,2,2,4,52
Great Scotts Eatery,Adams,1295 W Cortez St,1,4,5,51
Great Wall,Adams,1591 E Bridge St,8,14,22,34
Great West Life Building Compass 8109,Arapahoe,8505 E Orchard Rd,2,2,4,52
Greek Gyros,Adams,819 Thornton Pkwy,2,1,3,53
Greek To Me,Arapahoe,9251 E Peakview Ave Unit A,9,11,20,36
Green Bazaar,Arapahoe,5698 S Himalaya St Unit B/C,2,4,6,50
Green Chef,Arapahoe,16304 E 32nd Ave Unit 38,3,5,8,48
Greens Gone Wild,Adams,12189 Pennsylvania St,0,0,0,56
Greenwood Elementary,Arapahoe,5550 S Holly St,0,0,0,56
Greenwood Village Cafe,Arapahoe,8923 E Union Ave,0,1,1,55
Gregorios New Mexican Cuisine,Adams,9740 Grant St Unit 85,5,4,9,47
Grillin Wings and Things,Douglas,9447 Park Meadows Dr Ste B,2,3,5,51
Grizzly Rose,Adams,5450 N Valley Hwy,3,5,8,48
Grogans Pub,Adams,2091 Coronado Pkwy N,1,5,6,50
Growler USA,Arapahoe,11405 E Briarwood Ave Ste 100,5,5,10,46
Guadalajara,Douglas,150 Wolfensberger Rd,7,9,16,40
Guadalajara Family Mexican Restaurant,Arapahoe,1001 S Abilene St,5,6,11,45
Guadalajara Mexican Buffet,Adams,11385 E Colfax Ave,13,11,24,32
Guadalajara Mexican Restaurant,Adams,2835 W 72nd Ave,3,7,10,46
Guadalajara Sports Bar,Adams,2895 W 72nd Ave,1,2,3,53
Guardian Angels School,Adams,1843 W 52nd Ave,0,3,3,53
Guckenheimer at ULA,Arapahoe,7958 S Chester St,3,5,8,48
Gulzar Food Market,Arapahoe,10315 E Iliff Ave,9,6,15,41
Gunther Toodys,Adams,16755 Washington St,7,7,14,42
Gunther Toodys,Adams,301 W 104th Ave,0,0,0,56
Gyros & Kabobs,Arapahoe,2020 S Parker Rd Unit D,6,4,10,46
Gyroz,Arapahoe,13698 E Iliff Ave Unit A,3,6,9,47
Gyroz King,Arapahoe,15102 E Hampden Ave Ste B,4,4,8,48
H Mart Market/ Han Ah Reum,Arapahoe,2751 S Parker Rd,12,14,26,30
H Mart Westminster,Adams,5036 W 92nd Ave,5,9,14,42
H and G Asian Cafe,Arapahoe,7939 E Arapahoe Rd Unit 170,6,3,9,47
HSS Hot Breads Indian Cuisine,Arapahoe,9678 E Arapahoe Rd,13,12,25,31
Haat Bazar,Arapahoe,2648 S Parker Rd,4,0,4,52
Habibi Hookah Cafe,Arapahoe,3124 S Parker Rd Unit D,6,9,15,41
Hacienda Colorado,Douglas,10500 Bierstadt Way,5,8,13,43
Halftime Sports Bar,Adams,6051 Quebec St,4,3,7,49
Hamburger Stand 427,Adams,3030 W 72nd Ave,6,7,13,43
Hamburger Stand 646,Arapahoe,938 S Havana St,4,7,11,45
Hamburguesas Don Jesus,Adams,5318 Sheridan Blvd,3,2,5,51
Hampton Inn & Suites,Arapahoe,4150 E Kentucky Ave,4,6,10,46
Hampton Inn & Suites,Arapahoe,7079 S Kenton St,4,4,8,48
Hampton Inn Brighton,Adams,992 Platte River Blvd,4,0,4,52
Hampton Inn Suites Denver South Ridgegate,Douglas,10030 Trainstation Cir,3,2,5,51
Hampton Inn and Suites,Arapahoe,3095 W County Line Rd,0,0,0,56
Hampton Inn and Suites,Douglas,19010 Cottonwood Dr,4,3,7,49
Hana Matsuri,Adams,2821 W 120th Ave Ste 300,7,7,14,42
Hana Sushi,Arapahoe,16911 E Quincy Ave Unit A4,4,5,9,47
Hands of Thyme,Arapahoe,2020 S Parker Rd Unit I,1,2,3,53
Hangry Ohana,Douglas,10471 S Parker Rd Ste 1B,2,6,8,48
Hapa Sushi,Arapahoe,5380 Greenwood Plaza Blvd Ste 101,2,2,4,52
Happy Burrito Mexican Restaurant,Adams,695 Palmer Ave,4,7,11,45
Happy China,Arapahoe,4335 S Buckley Rd,7,9,16,40
Happy Sumo,Adams,14647 Delaware St Unit 100,4,5,9,47
Haraf Foods Market,Adams,10774 Belle Creek Blvd Apt 124,1,1,2,54
Harlequin Cafe,Arapahoe,7600 E Orchard Rd Unit 170 N,3,1,4,52
Harleys A Hot Dog Revolution,Arapahoe,1500 W Littleton Blvd Unit 112,6,9,15,41
Harris Park Elementary,Adams,4300 W 75th Ave,0,2,2,54
Haute Touch Catering,Adams,851 E Highway 224 Unit B3,5,3,8,48
Havana Market,Arapahoe,868 S Havana St,2,3,5,51
Havana Park,Arapahoe,10750 E Iliff Ave,1,1,2,54
Haveli Indian Cuisine,Arapahoe,301 E County Line Rd,12,12,24,32
Hawks Nest,Adams,5321 E 136th Ave,1,1,2,54
Healthy Habit Cafe,Arapahoe,4300 Cherry Creek Dr,1,5,6,50
Heaven Dragon,Adams,99 N Kuner Rd,10,7,17,39
Heaven Dragon Chinese Restaurant,Adams,3730 E 120th Ave,5,11,16,40
Heidis Brooklyn Deli,Adams,2239 Prairie Center Pkwy Unit A,4,7,11,45
Heidis Test Kitchen,Adams,400 W 104th Ave,5,2,7,49
Helgas German Restaurant and Deli,Arapahoe,14197 E Exposition Ave,4,1,5,51
Hemphill Middle School,Adams,2100 Wagner St,0,2,2,54
Henderson Elementary,Adams,12301 E 124th Ave,0,0,0,56
Heritage Eagle Bend Golf and Country Club,Arapahoe,23155 E Heritage Pkwy,4,2,6,50
Heritage Elementary,Arapahoe,6867 E Heritage Pl,0,0,0,56
Heritage Elementary,Douglas,3350 Summit View Pkwy,0,3,3,53
Heritage High School,Arapahoe,1401 W Geddes Ave,1,3,4,52
Heritage Todd Creek Golf Club,Adams,8455 Heritage Dr,9,5,14,42
Heros Pizzaria,Arapahoe,16070 E Dartmouth Ave,2,5,7,49
Hexing Garden,Arapahoe,7500 S University Blvd Unit 103-C,4,4,8,48
Hibachi Grill & Buffet,Arapahoe,1026 S Sable Blvd,7,6,13,43
Hickory House Ribs,Douglas,10335 S Parker Rd,6,6,12,44
Hidden Lake High School,Adams,7300 Lowell Blvd,2,1,3,53
Hidden Lakes Ballfield,Adams,3755 W 66th Ave,0,1,1,55
Hide Away Bar and Grill,Douglas,600 Jerry St,4,6,10,46
Hideaway Saloon,Adams,6171 Olive St,1,0,1,55
Hideaway Steakhouse The,Adams,2345 W 112th Ave,3,5,8,48
High Plains Diner,Adams,100 Bennett Ave Unit 2,3,6,9,47
High Point Academy,Arapahoe,6750 N Dunkirk St,2,3,5,51
Highland Elementary School,Arapahoe,711 E Euclid Ave,1,0,1,55
Highlands Ranch Golf Club,Douglas,9000 Creekside Way,4,3,7,49
Highlands Ranch High School,Douglas,9375 Cresthill Ln,2,1,3,53
Highlands Ranch Mansion,Douglas,9950 E Gateway Dr,0,0,0,56
Highline Elementary,Arapahoe,11000 E Exposition Ave,0,3,3,53
Hillcrest Elementary,Adams,10335 Croke Dr,0,2,2,54
Hilltop Tap House,Douglas,19878 Hilltop Rd Unit 111,6,11,17,39
Hilton Garden Inn,Arapahoe,600 S Colorado Blvd,5,4,9,47
Hilton Garden Inn,Douglas,1050 Plaza Dr,4,4,8,48
Hilton Garden Inn Denver South,Douglas,9290 S Meridian Blvd,3,3,6,50
Himalayan Curry House,Adams,2851 W 120th Ave Ste C100,7,7,14,42
Hinkley High School,Arapahoe,1250 Chambers Rd,1,4,5,51
Hira Cafe and Patisserie,Arapahoe,10782 E Iliff Ave,3,0,3,53
Hiro Japanese Buffet,Arapahoe,2797 S Parker Rd,11,11,22,34
Hissho Sushi,Douglas,9751 S Parker Rd,2,0,2,54
Hissho Sushi at Target 1471,Arapahoe,14200 E Ellsworth Ave,1,2,3,53
Hissho Sushi at Target 1806,Arapahoe,4301 E Virginia Ave,0,0,0,56
Hissho Sushi at Target 2023,Douglas,10001 Commons St,0,0,0,56
Hmong Grocery,Adams,7141 Irving St Unit A,0,4,4,52
Ho Mei,Adams,9170 Federal Blvd,4,7,11,45
Ho Mei Chinese Restaurant,Adams,8610 Washington St,6,3,9,47
Ho Wei Chinese,Adams,7262 Broadway,3,5,8,48
Holiday Inn Express,Adams,12030 Grant St,2,4,6,50
Holiday Inn Express,Adams,2212 S Medical Center Dr,1,5,6,50
Holiday Inn Express,Douglas,610 Genoa Way,1,0,1,55
Holiday Inn Express - Banquet Kitchen,Arapahoe,14200 E Colfax Ave,2,2,4,52
Holiday Inn Express Breakfast Area,Arapahoe,14200 E Colfax Ave,2,3,5,51
Holistic Pathways Daily Dose Juice,Arapahoe,3521 S Logan St,1,1,2,54
Holly Creek Retirement Community,Arapahoe,5500 E Peakview Ave,5,1,6,50
Holly Hills Elementary,Arapahoe,6161 E Cornell Ave,0,1,1,55
Holly Park Pool/ Snack Bar,Arapahoe,6651 S Krameria Way,2,1,3,53
Holly Ridge Primary School,Arapahoe,3301 S Monaco Pkwy,0,0,0,56
Hollywood Southglenn Stadium 14,Arapahoe,6901 S Vine St,1,0,1,55
Holy Trinity Catholic Church,Adams,3050 W 76th Ave,0,0,0,56
Home 2 Suites By Hilton DenverSouth Centennial Airport,Arapahoe,6640 S Paris St,2,0,2,54
Home Cafe,Arapahoe,2640 W Hampden Ave,5,1,6,50
Homestead Elementary,Arapahoe,7451 S Homestead Pkwy,1,0,1,55
Homewood Suites,Arapahoe,199 Inverness Dr W,4,7,11,45
Honduras Breeze,Arapahoe,1443 Chester St,11,9,20,36
Honey Baked Ham,Arapahoe,7050 E County Line Rd,1,0,1,55
Honey Baked Ham 701,Arapahoe,2690 S Havana St,2,1,3,53
Honey Bakery,Arapahoe,2000 S Havana St,3,3,6,50
Honey Bee Asian Bistro,Arapahoe,18541 E Hampden Ave Ste 124,6,4,10,46
Hoongs Palace,Arapahoe,10333 E Costilla Ave,11,15,26,30
Hooters,Arapahoe,2610 S Parker Rd,4,4,8,48
Hooters,Douglas,8334 Willow St,3,0,3,53
Hooters of Westminster,Adams,1111 W 120th Ave,3,6,9,47
Hope At Heights Academy,Adams,2300 W 90th Ave,3,0,3,53
Hope Brighton Leadership Primary,Adams,510 S 27th Ave,2,2,4,52
Hope Brighton Leadership Secondary,Adams,975 Platte River Blvd,1,3,4,52
Hope World Impact Academy,Adams,5155 E 64th Ave,2,0,2,54
Hope at Action Learning Academy Primary,Arapahoe,445 S Lansing St,1,0,1,55
Horizon Food and Gas,Arapahoe,1009 W Littleton Blvd,1,1,2,54
Horizon Middle School,Arapahoe,3981 S Reservoir Rd,0,0,0,56
Hot Wok Asian Cuisine,Adams,5020 W 92nd Ave,5,6,11,45
HuHot Mongolian Grill,Adams,14697 Delaware St Ste 1500,2,4,6,50
HuHot Mongolian Grill,Arapahoe,3698 S Natches Ct,4,5,9,47
Huakee BBQ,Adams,5072 W 92nd Ave Unit D2,2,2,4,52
Hulstrom Options K thru 8,Adams,11551 Wyco Dr,0,0,0,56
Hungry Howies Flavored Crust Pizza,Arapahoe,6040 S Gun Club Rd Unit F4,0,3,3,53
Hungry Wok,Douglas,5050 Factory Shops Blvd Unit 5,3,3,6,50
Hunters Glen Elementary,Adams,13222 Corona St,1,0,1,55
Huron Convenience Store,Adams,9500 Huron St,0,1,1,55
Hurts Donut Company,Douglas,12311 Pine Bluffs Way Ste 103,1,0,1,55
Hyatt House,Arapahoe,9280 E Costilla Ave,7,5,12,44
Hyatt Place Denver Airport,Adams,16250 E 40th Ave,5,5,10,46
Hyatt Place Denver South Park Meadows / Restaurant,Douglas,9030 Westview Rd,7,6,13,43
Hyatt Place Denver Tech Center,Arapahoe,8300 E Crescent Pkwy,4,1,5,51
Hyatt Place Denver/Cherry Creek,Arapahoe,4150 E Mississippi Ave,2,0,2,54
Hyderabad House Indian Cuisine,Arapahoe,7605 E Arapahoe Rd,4,5,9,47
Hyland Hills/ Concession Gold Course,Adams,9650 Sheridan Blvd,0,1,1,55
Hyland Hills/ Softball Field Complex,Adams,8650 Zuni St,1,3,4,52
I Team Manor,Arapahoe,1820 S Joliet St,0,0,0,56
IHOP,Adams,221 W 104th Ave,2,5,7,49
IHOP,Arapahoe,13650 E Colfax Ave Unit L,3,4,7,49
IHOP 1818,Arapahoe,7017 S Clinton St,2,7,9,47
IHOP 1821,Arapahoe,13700 E Mississippi Ave,0,2,2,54
IHOP 1825,Douglas,575 Genoa Way,2,8,10,46
IHOP 1830,Adams,4730 W 120th Ave,2,5,7,49
IHOP 1831,Douglas,9565 S University Blvd,2,7,9,47
IHOP 1833,Douglas,11133 S Parker Rd,1,3,4,52
IHOP 1838,Arapahoe,5820 S Parker Rd,2,3,5,51
IKEA 064 Restaurant,Arapahoe,9800 E Ikea Way,1,5,6,50
Ichiban Buffet,Douglas,9271 Park Meadows Dr,7,6,13,43
Ifka Cafe,Arapahoe,1535 S Havana St Unit M,4,5,9,47
Illegal Burger,Arapahoe,652 S Colorado Blvd,2,1,3,53
Illegal Petes,Arapahoe,5312 DTC Blvd Unit 400,0,3,3,53
Imagirifik,Arapahoe,16748 E Smoky Hill Rd,4,0,4,52
In The Dog House LLC,Adams,617 Bridge St,4,1,5,51
Independence Elementary,Arapahoe,4700 S Memphis St,0,2,2,54
Indian Ridge Elementary,Arapahoe,16501 E Progress Dr,0,1,1,55
Indias Best Restaurant and Bar,Arapahoe,1500 W Littleton Blvd Unit,10,12,22,34
Indias Harvest,Arapahoe,3095 S Peoria St Unit D,3,3,6,50
Indias Kitchen,Douglas,18701 E Mainstreet Ste 2,5,9,14,42
Indias Kitchen 3,Arapahoe,16270 E Arapahoe Rd Unit 202,5,6,11,45
Indias Kitchen II,Arapahoe,8236 S Holly St,4,8,12,44
Indochine,Douglas,19751 E Mainstreet Unit R2,9,6,15,41
Indulge Bistro and Wine Bar,Arapahoe,6955 S York St Ste 406,2,5,7,49
Indulge Wine Bar,Douglas,1601 Mayberry Dr Ste 101,3,5,8,48
Infinity Middle School,Arapahoe,25100 E Belleview Ave,0,0,0,56
Infinity Park Events Center,Arapahoe,4400 E Kentucky Ave,1,2,3,53
Infuzed Soda Bar,Adams,13762 Colorado Blvd Unit 124,3,3,6,50
Ink Coffee Company & Cabana,Arapahoe,5801 S Quebec St,2,2,4,52
Inova Cafe,Arapahoe,7250 S Havana St,5,6,11,45
Insights Center,Douglas,345 Inverness Dr S Unit A-110,0,2,2,54
Inta Juice,Douglas,19539 Hess Rd Unit 105,0,1,1,55
International House of Pancakes,Arapahoe,800 Englewood Pkwy Unit A100,3,4,7,49
International House of Pancakes 3073,Adams,962 S 4th Ave,2,8,10,46
Inverness Cafe,Arapahoe,175 Inverness Dr W Ste 110,4,3,7,49
Inverness Hotel and Golf Club Main Kitchen,Arapahoe,200 Inverness Dr W,0,3,3,53
Iowa Elementary,Arapahoe,16701 E Iowa Ave,0,2,2,54
Iron Horse Elementary,Douglas,20151 Tallman Dr,0,1,1,55
Isaac Newton Middle School,Arapahoe,4001 E Arapahoe Rd,0,0,0,56
Island The,Arapahoe,2233 S Geneva St,1,1,2,54
Ivibe Coffee,Adams,5191 W 112th St Ste 700,4,3,7,49
J Alexanders Restaurant,Arapahoe,9709 E County Line Rd,7,6,13,43
J P Asian Bistro Corporation,Douglas,8351 N Rampart Range Rd Unit C101,8,0,8,48
JA Balistreri Vineyards,Adams,1946 E 66th Ave,1,4,5,51
JDs Bait Shop and Sports Grill,Arapahoe,9555 E Arapahoe Rd Unit 14,3,0,3,53
JDs Market,Douglas,8808 S Colorado Blvd,1,2,3,53
JFE,Douglas,9551 S University Blvd,0,0,0,56
JFE KS 16,Arapahoe,19711 E Smoky Hill Rd,1,0,1,55
JFE Snowfox JFE Sushi,Douglas,5544 Promenade Pkwy,0,0,0,56
JFE Snowfox KS075,Douglas,12959 S Parker Rd,0,0,0,56
JFE Sushi,Adams,10351 Federal Blvd,1,2,3,53
JFE Sushi,Douglas,2205 W Wildcat Reserve Pkwy,1,1,2,54
JFE Sushi 126,Douglas,17761 Cottonwood Dr,0,1,1,55
JFE Sushi 132,Douglas,750 N Ridge Rd,1,2,3,53
JFE Sushi KS 107,Arapahoe,25701 E Smoky Hill Rd,0,0,0,56
JFE Sushi KS 131,Arapahoe,100 W Littleton Blvd,0,1,1,55
JFE Sushi KS-109,Arapahoe,5050 S Federal Blvd Unit,1,0,1,55
JFE Sushi KS100,Arapahoe,4910 S Yosemite St,0,0,0,56
JFE Sushi KS91,Douglas,7284 Lagae Rd,0,0,0,56
JJ Market,Arapahoe,20961 E Smoky Hill Rd,2,1,3,53
JP Nori Sushi and Asian Cuisine,Arapahoe,5302 S Federal Cir Unit B,7,6,13,43
Jabaneros Mexican Grill,Arapahoe,5584 S Parker Rd Ste A3,3,2,5,51
Jabos Bar Be Q,Arapahoe,9682 E Arapahoe Rd,6,2,8,48
Jack Rabbit Gas,Adams,56491 E Colfax Ave,4,7,11,45
Jack in the Box 8128,Adams,15255 E 38th Ave,1,5,6,50
Jack in the Box 8131,Douglas,11179 S Pikes Peak Dr,6,6,12,44
Jack in the Box 8135,Adams,9703 Washington St,0,6,6,50
Jack in the Box 8136,Adams,6015 E Parkway Dr,1,2,3,53
Jack in the Box 8137,Arapahoe,15399 E Mississippi Ave,1,2,3,53
Jack in the Box 8157,Douglas,27 Wolfensberger Rd,0,7,7,49
Jack in the Box 8162,Adams,64 W Bromley Ln,2,4,6,50
Jackass Hill Brewery,Arapahoe,2409 W Main St,0,0,0,56
Jackie Chan Chinese Kitchen,Adams,7318 Federal Blvd Unit B,7,4,11,45
Jakes Beer Garden,Arapahoe,2530 W Main St,3,3,6,50
Jalapeno Deluxe,Arapahoe,15490 E Colfax Ave Unit B,10,13,23,33
Jalapenos,Arapahoe,3120 S Broadway,4,3,7,49
Jamba Juice 1711,Arapahoe,6202 S Parker Rd Ste 100,0,0,0,56
Jamba Juice 491,Arapahoe,14151 E Cedar Ave Unit A,0,5,5,51
Jamba Juice 531,Arapahoe,4950 S Yosemite St Unit F1,2,3,5,51
Jamba Juice 680,Arapahoe,24107 E Commons Ave Ste 101,2,3,5,51
Jasmin Syrian Food,Arapahoe,10180 E Colfax Ave Unit 186,1,1,2,54
Jasmine Asian Cafe,Douglas,9400 Heritage Hills Cir Ste 400,3,12,15,41
Jasons Deli,Arapahoe,5302 DTC Blvd Unit 400,3,1,4,52
Jasons Deli,Arapahoe,5440 S Parker Rd,1,1,2,54
Jasons Deli,Arapahoe,9525 E County Line Rd,3,9,12,44
Jax Fish House,Arapahoe,650 S Colorado Blvd Bldg A,3,2,5,51
Jay Grille and Bar,Adams,7820 N Washington St Unit A,3,3,6,50
Jennys Market,Adams,3690 E 104th Ave,5,1,6,50
Jerrys Bar and Grill,Adams,130 N Main St,6,6,12,44
Jersey MIkes Subs,Douglas,4989 Factory Shops Blvd Unit A-230,4,2,6,50
Jersey Mikes,Adams,2690 W 104th Ave Unit 140,1,4,5,51
Jersey Mikes Sub,Adams,12003 N Pecos St,4,7,11,45
Jersey Mikes Sub,Arapahoe,23870 E Smoky Hill Rd Ste 20,3,4,7,49
Jersey Mikes Subs,Arapahoe,2456 S Parker Rd Ste B,3,1,4,52
Jersey Mikes Subs,Arapahoe,3571 S Tower Rd Unit E,5,5,10,46
Jersey Mikes Subs,Arapahoe,4989 S Broadway Unit B,1,1,2,54
Jersey Mikes Subs,Arapahoe,5137 S Yosemite St,1,1,2,54
Jersey Mikes Subs,Arapahoe,6583 S Parker Rd Unit 200,5,2,7,49
Jersey Mikes Subs,Douglas,18366 Lincoln Ave Unit 107,2,2,4,52
Jersey Mikes Subs,Douglas,9362 S Colorado Blvd Unit D4,1,3,4,52
Jersey Mikes Subs,Douglas,9400 Heritage Hills Cir Ste 300,3,2,5,51
Jessies Smokin Nola,Arapahoe,7422 S University Blvd,5,2,7,49
Jesuit Retreat House,Douglas,4801 Highway 67,2,6,8,48
Jesus Mexican Taqueria,Arapahoe,1701 S Buckley Rd,4,3,7,49
Jets Pizza,Arapahoe,13724 E Quincy Ave,3,3,6,50
Jets Pizza,Arapahoe,7935 S Broadway,4,2,6,50
Jets Pizza,Arapahoe,8176 S Holly St,1,0,1,55
Jets Pizza,Douglas,19878 E Hilltop Rd Unit 101,1,2,3,53
Jewel Elementary,Arapahoe,14601 E Jewell Ave,0,1,1,55
Jewel of India,Adams,10343 Federal Blvd Unit P,6,8,14,42
Jim N Nicks BBQ,Adams,100 E 120th Ave Bldg E,1,6,7,49
Jim N Nicks Bar B Q,Arapahoe,24153 E Prospect Ave,3,9,12,44
Jimanos Pizzeria,Arapahoe,2950 S Broadway Unit G,4,2,6,50
Jimmy John,Douglas,5646 Allen Way Ste 120,4,5,9,47
Jimmy Johns,Adams,10449 Chambers Rd,5,0,5,51
Jimmy Johns,Adams,12501 E 17th Ave,7,4,11,45
Jimmy Johns,Adams,3954 E 120th Ave,1,2,3,53
Jimmy Johns,Adams,3995 Lewiston St Unit 104,1,4,5,51
Jimmy Johns,Adams,9645 Washington St Unit 170,3,6,9,47
Jimmy Johns,Arapahoe,1140 S Colorado Blvd,0,0,0,56
Jimmy Johns,Arapahoe,23903 E Prospect Ave Unit D,1,2,3,53
Jimmy Johns,Arapahoe,2610 W Belleview Ave Ste 600,4,1,5,51
Jimmy Johns,Arapahoe,3001 S Broadway,3,3,6,50
Jimmy Johns,Douglas,11804 E Oswego St Unit B,3,2,5,51
Jimmy Johns,Douglas,390 S Wilcox St,2,2,4,52
Jimmy Johns,Douglas,9325 Dorchester St Ste 126,2,1,3,53
Jimmy Johns 1468,Arapahoe,4261 S Buckley Rd Ste B,1,1,2,54
Jimmy Johns 1494,Arapahoe,91 W Mineral Ave Unit 110,1,1,2,54
Jimmy Johns 1921,Arapahoe,14302 Cedar Ave Unit F,2,1,3,53
Jimmy Johns 2615,Douglas,18320 E Cottonwood Dr Unit J,1,0,1,55
Jimmy Johns 3939,Douglas,9567 S University Blvd Ste D2,6,5,11,45
Jimmy Johns 455,Arapahoe,4682 S Yosemite St,0,0,0,56
Jimmy Johns 635,Douglas,9234 Park Meadows Dr Ste 500,5,2,7,49
Jimmy Johns Gourmet,Arapahoe,7530 S University Blvd Unit 130,2,1,3,53
Jimmy Johns No 2707,Adams,14315 Orchard Pkwy,3,0,3,53
Jims Burger Haven,Adams,595 E 88th Ave,3,8,11,45
Jing,Arapahoe,5370 Greenwood Plaza Blvd Unit I,10,3,13,43
Jjs Kitchen,Adams,2181 Lake Ave,3,2,5,51
Joes Crab Shack,Adams,8911 Yates St,3,2,5,51
Joes Crab Shack,Arapahoe,14025 E Evans Ave,0,4,4,52
John Custy Legion Post 151,Adams,5421 E 71st Ave,0,1,1,55
John Flynn Elementary/ SAT,Adams,8731 Lowell Blvd,1,2,3,53
John Hollys Asian Bistro,Douglas,9232 Park Meadows Dr,1,1,2,54
Johnnys Asian Bistro,Douglas,10471 S Parker Rd Ste 3C,4,10,14,42
Johnnys Italian Steakhouse,Adams,14275 Lincoln St,3,4,7,49
Johnson Adult Day Program,Arapahoe,3444 S Emerson St,2,0,2,54
Jolet Coffee Factory,Adams,11505 E Colfax Ave,5,5,10,46
Joliet Learning Center,Arapahoe,1855 S Joliet St,0,0,0,56
Jordinellis Sports Bar,Adams,25 N Main St,4,10,14,42
Josephine Hodgkins Elementary,Adams,3475 W 67th Ave,0,2,2,54
Joust Kitchen,Douglas,650 Perry Park Rd,3,3,6,50
Joy Asian Cuisine,Arapahoe,1250 S Buckley Rd Unit G,4,4,8,48
Joy Sushi,Douglas,7600 Park Meadows Dr Ste 100,7,8,15,41
Js Noodles and New Thai,Arapahoe,1842 S Parker Rd Unit 5,9,6,15,41
Juans Super Pollo LLC,Arapahoe,1593 Peoria St,3,8,11,45
Jubilee Roasting Co,Adams,1452 Kenton St,3,2,5,51
Juice Pop,Arapahoe,2751 S Parker Rd Unit 302,2,1,3,53
Juiceland,Arapahoe,784 Peoria St,2,3,5,51
Juicy Seafood,Arapahoe,2727 S Parker Rd,3,4,7,49
Jump Start Cafe,Arapahoe,6770 S Yosemite St,5,7,12,44
Jumpin Jack Snacks,Adams,5951 Monaco St,1,0,1,55
Junz Restaurant,Douglas,11211 Dransfeldt Rd Ste 100,3,7,10,46
Jus Coffee,Douglas,17908 Cottonwood Dr Ste A,1,2,3,53
Jus Grill,Arapahoe,6780 S Liverpool St Unit D,1,2,3,53
Jus Grill Restaurant,Arapahoe,17200 E Iliff Ave Unit A10,8,6,14,42
Justice Center Deli,Douglas,4000 Justice Way # 2031,0,1,1,55
K Fusion,Adams,800 E 73rd Ave,1,0,1,55
K and T Gas Station,Arapahoe,15351 E Iliff Ave,4,2,6,50
KCs Lounge,Adams,3001 W 71st Way,1,2,3,53
KFC,Adams,15101 E 104th Ave,3,5,8,48
KFC,Douglas,9804 S Yosemite St,2,5,7,49
KFC A and W,Arapahoe,1551 S Havana St,0,2,2,54
KFC A and W,Douglas,186 Metzler Dr,1,5,6,50
KFC Long John Silvers,Adams,250 W 136th Ave,3,6,9,47
KFC Long John Silvers,Adams,4740 E Bromley Ln,1,5,6,50
KFC Long John Silvers,Arapahoe,24223 E Prospect Ave,3,3,6,50
KP Asian Cafe,Arapahoe,12201 E Mississippi Ave Unit 111,5,6,11,45
KS 81 Sushi,Adams,500 E Bromley Ln Unit A,2,2,4,52
Kabob Station,Adams,12041 Pecos St,3,3,6,50
Kaladi Coffee Roasters,Arapahoe,2823 S Broadway,2,4,6,50
Katsu Ramen,Arapahoe,1930 S Havana St Unit 4,4,6,10,46
Kearney Middle School,Adams,6160 Kearney St,1,1,2,54
Kellys Cajun Grill,Arapahoe,14200 E Alameda Ave Ste 2068A,9,6,15,41
Kemp Elementary,Adams,6775 Oneida St,0,0,0,56
Kent Denver School,Arapahoe,4000 E Quincy Ave,1,1,2,54
Kenton Elementary,Arapahoe,1255 Kenton St,0,1,1,55
Kentucky Fried Chicken,Adams,14411 E Colfax Ave,1,6,7,49
Kentucky Fried Chicken,Adams,2581 E 120th Ave,2,5,7,49
Kentucky Fried Chicken,Adams,9185 Federal Blvd,0,3,3,53
Kentucky Fried Chicken,Arapahoe,15290 E Mississippi Ave,2,3,5,51
Kentucky Fried Chicken 447,Douglas,9215 S Broadway,0,4,4,52
Kentucky Fried Chicken 462,Adams,10790 Washington St,2,3,5,51
Kentucky Fried Chicken 463,Adams,7140 Pecos St,0,3,3,53
Kentucky Fried Chicken 487,Adams,5101 E 60th Ave,0,1,1,55
Kentucky Fried Chicken A and W,Arapahoe,2900 W Belleview Ave,1,4,5,51
Kentucky Fried Chicken A and W,Douglas,1960 E County Line Rd,0,3,3,53
Keystone Place at Legacy Ridge,Adams,11180 Irving Dr,1,3,4,52
Khulan Kafe,Douglas,8820 American Way,1,0,1,55
Kicks 66,Arapahoe,8755 E Arapahoe Rd,2,1,3,53
Kids Wonder,Arapahoe,7562 S University Blvd Ste GG,1,0,1,55
Kikka,Adams,4451 Main St,0,1,1,55
Kikka Sushi,Arapahoe,870 S Colorado Blvd,0,0,0,56
Kikos,Adams,290 N Main St,8,10,18,38
Kilwins Chocolate,Douglas,19501 E Main St,0,2,2,54
King Soopers,Arapahoe,3050 S Peoria St,2,1,3,53
King Soopers,Douglas,5544 Promenade Pkwy,2,5,7,49
King Soopers 063 Sushi,Arapahoe,8200 S Holly St,0,0,0,56
King Soopers 068 - JFE Sushi,Adams,3801 E 120th Ave,1,1,2,54
King Soopers 088 Sushi,Douglas,17031 Lincoln Ave,0,0,0,56
King Soopers 10,Arapahoe,15250 E Mississippi Ave,0,3,3,53
King Soopers 100,Arapahoe,4910 S Yosemite St Unit,1,2,3,53
King Soopers 101 and Coffee Shop,Adams,13700 Colorado Blvd,4,4,8,48
King Soopers 107,Arapahoe,25701 E Smoky Hill Rd,0,0,0,56
King Soopers 108,Douglas,4000 Red Cedar Dr,2,3,5,51
King Soopers 109,Arapahoe,5050 S Federal Blvd Unit,4,2,6,50
King Soopers 110,Douglas,8673 S Quebec St,1,4,5,51
King Soopers 111,Arapahoe,3495 S University Blvd,3,2,5,51
King Soopers 112,Adams,1045 S 1st St,5,9,14,42
King Soopers 114,Adams,15051 E 104th Ave,3,3,6,50
King Soopers 122 and Starbucks,Arapahoe,7901 S Broadway,0,4,4,52
King Soopers 124,Arapahoe,4600 Leetsdale Dr,2,2,4,52
King Soopers 124 Sushi,Arapahoe,4600 Leetsdale Dr,1,0,1,55
King Soopers 126,Douglas,17761 Cottonwood Dr,1,2,3,53
King Soopers 128,Arapahoe,18211 E Hampden Ave,3,1,4,52
King Soopers 131,Arapahoe,100 W Littleton Blvd,4,5,9,47
King Soopers 132,Douglas,750 N Ridge Rd,2,6,8,48
King Soopers 136,Adams,100 N 50th Ave,3,4,7,49
King Soopers 136 Snow Fox Sushi,Adams,100 N 50th Ave,2,0,2,54
King Soopers 14,Arapahoe,655 Peoria St,6,5,11,45
King Soopers 16,Arapahoe,19711 E Smoky Hill Rd,3,8,11,45
King Soopers 24,Adams,750 E 104th Ave,2,3,5,51
King Soopers 27,Douglas,9551 S University Blvd,1,6,7,49
King Soopers 3 and Coffee Shop,Adams,6350 Sheridan Blvd,0,4,4,52
King Soopers 30,Arapahoe,1155 S Havana St,0,5,5,51
King Soopers 34,Adams,1575 W 84th Ave,2,3,5,51
King Soopers 38,Arapahoe,5050 E Arapahoe Rd,1,4,5,51
King Soopers 39,Arapahoe,3190 S Parker Rd,1,2,3,53
King Soopers 47,Arapahoe,7575 S University Blvd,1,3,4,52
King Soopers 49,Arapahoe,17000 E Iliff Ave,1,1,2,54
King Soopers 52,Adams,15109 E Colfax Ave,2,4,6,50
King Soopers 62 and Coffee Shop,Adams,10351 Federal Blvd,2,2,4,52
King Soopers 63,Arapahoe,8200 S Holly St,6,6,12,44
King Soopers 65,Arapahoe,101 Englewood Pkwy,0,4,4,52
King Soopers 68,Adams,3801 E 120th Ave,2,3,5,51
King Soopers 69,Arapahoe,4271 S Buckley Rd,3,4,7,49
King Soopers 75,Douglas,12959 S Parker Rd,1,4,5,51
King Soopers 8,Douglas,2205 W Wildcat Reserve Pkwy,1,6,7,49
King Soopers 81,Adams,500 E Bromley Ln,2,2,4,52
King Soopers 84,Arapahoe,6412 S Parker Rd,4,6,10,46
King Soopers 88,Douglas,17031 Lincoln Ave,2,5,7,49
King Soopers 91,Douglas,7284 Lagae Rd,2,4,6,50
King Soopers 92,Adams,4850 E 62nd Ave,0,2,2,54
King Soopers 96,Arapahoe,6000 S Holly St,2,2,4,52
King Soopers JFE Sushi LLC,Douglas,8673 S Quebec St,0,0,0,56
King Wok Express,Arapahoe,1740 S Buckley Rd Unit 7,3,2,5,51
Kings Cookery The,Douglas,650 Perry Park Rd,0,0,0,56
Kitchen Next Door The,Douglas,1485 Park Central Dr Ste 300,2,0,2,54
Kneaders Bakery & Cafe,Adams,9785 Washington St,5,1,6,50
Kneaders Bakery & Cafe,Douglas,19190 E Main St,3,7,10,46
Kneaders Bakery & Cafe of Aurora,Arapahoe,14455 E Arapahoe Rd,2,1,3,53
Kneaders Bakery & Cafe of Castle Rock,Douglas,826 New Memphis Ct,4,9,13,43
Kneaders of Highlands Ranch,Douglas,1105 Sgt Jon Stiles Dr,2,5,7,49
Kneaders of Lone Tree,Douglas,9846 Zenith Meridian Dr,1,3,4,52
Knights of Columbus,Adams,1096 E Bridge St,3,9,12,44
Konark Grocers,Arapahoe,7152 E County Line Rd,2,2,4,52
Korean Kim Chi and Foods,Arapahoe,2720 S Havana St Unit I,6,7,13,43
Krispy Kreme Doughnuts,Adams,1051 E 120th Ave,2,1,3,53
Kum & Go 0321,Adams,237 E 120th Ave,4,1,5,51
Kum and Go,Adams,2150 E Bridge St,5,5,10,46
Kum and Go,Adams,250 E 136th Ave,2,1,3,53
Kum and Go,Adams,5480 E 120th Ave,2,0,2,54
Kum and Go,Adams,7450 Federal Blvd,1,0,1,55
Kunjani Coffea,Douglas,10009 Jordan Rd,5,2,7,49
Kurosawa Asian Bistro,Douglas,17002 E Main,9,6,15,41
L and L Hawaiian Barbecue,Arapahoe,14221 E Cedar Ave Unit C,2,8,10,46
L and L Hawaiian Mixplate,Arapahoe,5650 S Chambers Rd,3,0,3,53
L and M Grocery Store,Arapahoe,16251 E Colfax Ave Ste 111,6,7,13,43
La Baguette De Normandie LLC,Douglas,16524 Keystone Blvd Unit C,1,6,7,49
La Belle Vita Fitness Facility,Douglas,8285 Dante Dr,0,0,0,56
La Botana,Adams,8995 Washington St,11,12,23,33
La Buena Vida Panaderia,Adams,1854 W 92nd Ave,4,9,13,43
La Casa Del Rey,Adams,7035 E 72nd Ave,0,0,0,56
La Casita Mexican Restaurant,Douglas,18951 E Mainstreet Ste A,7,7,14,42
La Changada,Adams,8923 N Washington St,3,5,8,48
La Chilanga,Adams,2755 W 72nd Ave,3,3,6,50
La Chispa Night Club LLC,Adams,6190 E 72nd Ave,3,1,4,52
La Costera Grill Chicken,Adams,9755 Montview Blvd,8,11,19,37
La Cueva,Arapahoe,9742 E Colfax Ave,1,3,4,52
La Estrellita,Adams,45 N Main St Unit 9,11,6,17,39
La Flor Michoacana 1,Adams,1792 W 92nd Ave,3,4,7,49
La Fogata III,Adams,16600 Washington St,8,5,13,43
La Gaviota Mexican Restaurant,Arapahoe,2280 S Quebec St Unit B & C,5,4,9,47
La Guatemalteca,Adams,10329 E Colfax Ave,9,9,18,38
La Hoya Mexican Food,Arapahoe,596 Dayton St,4,7,11,45
La Michoacana es Natural,Adams,450 E Bromley Ln Unit 130,3,3,6,50
La Montagne Des Saveurs,Adams,12189 Pennsylvania St,1,0,1,55
La Morena Mexican Restaurant,Arapahoe,9650 E Colfax Ave,7,6,13,43
La Nueva America,Adams,9299 Federal Blvd,8,8,16,40
La Petite Creperie,Douglas,19751 E Mainstreet,4,3,7,49
La Plazita,Adams,7253 Monaco St,2,1,3,53
La Poblanita,Adams,1830 W 92nd Ave,4,2,6,50
La Promesse,Arapahoe,576 Hanover Way Unit A,1,2,3,53
La Quinta,Adams,345 W 120th Ave,3,3,6,50
La Quinta 653,Adams,8701 W Turnpike Dr,2,8,10,46
La Quinta Inn and Suites,Arapahoe,1500 S Abilene St,4,1,5,51
La Quinta Inn and Suites 946,Arapahoe,7077 S Clinton St,5,4,9,47
LaMars Donuts,Arapahoe,10001 E Iliff Ave,4,2,6,50
Lacuna Coffee Company,Arapahoe,25511 E Smoky Hill Rd,4,1,5,51
Lake Avenue Inn,Adams,2181 Lake Ave,3,0,3,53
Lake House at Cherry Creek,Arapahoe,4800 S Dayton St,0,0,0,56
Lamars Donuts,Arapahoe,5350 S Santa Fe Dr Unit E,6,10,16,40
Lamars Donuts,Douglas,9360 S Colorado Blvd,2,4,6,50
Land of Sushi,Arapahoe,2412 E Arapahoe Rd,2,4,6,50
Landeros Restaurant,Arapahoe,12507 E Mississippi Ave Unit 302,1,4,5,51
Landmark Academy,Adams,10566 Memphis St,0,0,0,56
Landmark Theatre,Arapahoe,5415 Landmark Pl,3,6,9,47
Landrys Seafood House,Arapahoe,7209 S Clinton St,4,11,15,41
Lansdowne Arms,Douglas,9352 Dorchester St,3,6,9,47
Lansing Elementary,Arapahoe,551 Lansing St,0,0,0,56
Lao Market,Adams,7302 Federal Blvd,0,3,3,53
Laredo Elementary,Arapahoe,1350 Laredo St,0,2,2,54
Laredo Middle School,Arapahoe,5000 S Laredo St,0,2,2,54
Larkburger III,Arapahoe,8000 E Belleview Ave Unit B45,6,2,8,48
Larkspur Elementary,Douglas,1103 W Perry Park Ave,0,0,0,56
Larkspur Pizzaria and Cafe,Douglas,8815 Spruce Mountain Rd,3,5,8,48
Las Brisas Restaurant,Arapahoe,6787 S Clinton St,9,11,20,36
Las Delicias 2,Adams,7610 Conifer Rd,5,4,9,47
Las Delicias 4,Douglas,19553 E Mainstreet,4,5,9,47
Las Delicias 5,Arapahoe,4301 E Kentucky Ave,5,6,11,45
Las Fajitas Mexican Restaurant,Arapahoe,2680 S Havana St Unit A,4,5,9,47
Las Fajitas Mexican Restaurant,Arapahoe,7450 S Gartrell Rd Unit B7,3,6,9,47
Las Fajitas Mexican Restaurant,Douglas,562 E Castle Pines Pkwy Unit C12,5,6,11,45
Las Fresas,Arapahoe,489 Sable Blvd Unit A,2,2,4,52
Las Hadas Mexican Restaurant,Arapahoe,15264 E Hampden Ave,7,8,15,41
Las Islas Marias,Arapahoe,12203 E Iliff Ave Ste L,8,4,12,44
Las Margs at Reunion,Adams,15550 E 103rd Pl Unit 112,8,8,16,40
Las Mariposas Neveria,Arapahoe,2300 S Chambers Rd Unit H,6,7,13,43
Las Palmas Mexican Restaurant,Adams,3965 E 120th Ave,6,7,13,43
Las Tortas,Adams,1848 W 92nd Ave,5,3,8,48
Las Tortugas,Adams,7600 Highway 2,3,4,7,49
Las Tortugas,Adams,810 E 88th Ave Unit 100,5,1,6,50
Las Tortugas,Arapahoe,3140 S Parker Rd Unit 13,4,3,7,49
Las Tortugas,Arapahoe,712 Peoria St,4,2,6,50
Laszlo Hotel,Douglas,18595 Mainstreet,8,2,10,46
Latke Love,Arapahoe,699 W Littleton Blvd,0,0,0,56
Lauer Krauts,Adams,26 S 6th Ave Unit B,2,2,4,52
Lava Island,Arapahoe,452 Sable Blvd Unit A,2,4,6,50
Lazy Dog Restaurant,Adams,14618 Delaware St,9,5,14,42
Lazy Dog Restaurant and Bar,Arapahoe,24110 E State Ave,6,5,11,45
Le Peep Grill of Highlands Ranch,Douglas,7156 E County Line Rd,2,3,5,51
Le Peep of Centennial,Arapahoe,15352 E Ida Dr,1,2,3,53
Leche Y Miel,Arapahoe,12415 E Mississippi Ave,3,0,3,53
Legacy Point Elementary,Douglas,12736 Red Rosa Cir,1,4,5,51
Legend High School,Douglas,22219 Hilltop Rd,0,2,2,54
Legends of Aurora,Arapahoe,13690 E Iliff Ave Unit J,2,6,8,48
Leroy Drive Elementary,Adams,1451 Leroy Dr,0,1,1,55
Lester Arnold High School,Adams,6500 E 72nd Ave,2,1,3,53
Level Up Nutrition,Arapahoe,3916 S Broadway,2,2,4,52
Liberty Middle School,Arapahoe,21500 E Dry Creek Rd,0,1,1,55
Library Co The,Douglas,3911 Ambrosia St Ste 101,9,7,16,40
Life Adult Day Care,Arapahoe,1390 S Potomac St Ste 116,0,0,0,56
Life Cafe Poolside,Arapahoe,5000 E Dry Creek Rd,5,2,7,49
Life Time Athletic (northeast bldg),Arapahoe,5000 E Dry Creek Rd,0,0,0,56
Life Time Fitness,Adams,397 W 148th Ave,4,6,10,46
Like Tea,Arapahoe,8433 Park Meadows Center Dr Unit D144A,6,1,7,49
Lil Riccis,Arapahoe,5322 DTC Blvd Unit 100,5,1,6,50
Lil Riccis NY Pizzeria,Douglas,16526 Keystone Blvd Unit G,5,8,13,43
Limon y Sal,Adams,2400 E 88th Ave Unit J,3,0,3,53
Lincoln Station,Douglas,9360 Station St Ste 175,7,8,15,41
Liniger Bldg at CU South Denver - Restaurant,Douglas,10035 S Peoria St,2,4,6,50
Links Golf Course,Douglas,5815 Gleneagles Village Pkwy,1,1,2,54
Lisa Annes Country Cupboard Bakery,Adams,12400 First St,5,3,8,48
Lisas Place,Adams,10285 Washington St,1,2,3,53
Little Basil,Arapahoe,7923 S Broadway,4,3,7,49
Little Caesars 113,Arapahoe,3105 S Peoria St Unit H,2,0,2,54
Little Caesars 120,Adams,5940 E 64th Ave,2,3,5,51
Little Caesars 124,Adams,10459 Chambers Rd,3,4,7,49
Little Caesars Pizza,Arapahoe,5050 S Federal Blvd Unit 26,0,0,0,56
Little Caesars Pizza,Douglas,17002 E Mainstreet,1,4,5,51
Little Caesars Pizza,Douglas,4625 Trail Boss Dr Unit B,1,5,6,50
Little Caesars Pizza 1783,Douglas,1100 Sgt Jon Stiles Dr Unit 102,3,4,7,49
Little Ceasars 125,Adams,7792 Washington St,1,0,1,55
Little Holly Asian Cafe,Douglas,2223 W Wildcat Reserve Pkwy Unit G4,6,4,10,46
Little Miss Latte,Adams,9191 Grant St,4,3,7,49
Little Monkey Bizness,Douglas,10430 S Progress Way,1,1,2,54
Little Panda Express,Arapahoe,523 Havana St,10,8,18,38
Littleton Academy,Arapahoe,1200 W Mineral Ave,0,0,0,56
Littleton Adventist Hospital,Arapahoe,7700 S Broadway,4,3,7,49
Littleton Cafe,Arapahoe,1409 W Littleton Blvd,6,10,16,40
Littleton Conoco,Arapahoe,5890 S Santa Fe Dr,2,3,5,51
Littleton Golf and Tennis Club,Arapahoe,5800 S Federal Blvd,2,3,5,51
Littleton High School,Arapahoe,199 E Littleton Blvd,0,0,0,56
Littleton Lodge BPOE 1650,Arapahoe,5749 S Curtice St,6,1,7,49
Littleton Preparatory Charter School,Arapahoe,5301 S Bannock St,0,1,1,55
Littleton United Methodist Church,Arapahoe,5894 S Datura St,0,0,0,56
Lizzies Axe Throwing,Adams,345 S Main St,0,1,1,55
Loaf N Jug 11 Blimpie Subs,Douglas,4901 Castleton Dr,0,3,3,53
Loaf N Jug 7,Douglas,9028 S Woodman Way,1,2,3,53
Local The,Arapahoe,6205 SW Main St Unit D-106,3,0,3,53
Local The,Douglas,19565 E Mainstreet,1,2,3,53
Local cafe,Arapahoe,6501 S Fiddlers Green Cir,3,0,3,53
Lockheed Martin DDC,Adams,1401 Del Norte St,1,0,1,55
Lodos Bar and Grill,Douglas,8545 S Quebec St,2,3,5,51
Lodos Bar and Grill Westminster,Adams,3053 W 104th Ave,8,9,17,39
Logan House Coffee,Arapahoe,2501 Dallas St Ste 112,8,2,10,46
Lois Lenski Elementary,Arapahoe,6350 S Fairfax Way,0,0,0,56
Lone Tree Elementary,Douglas,9375 Heritage Hills Cir,0,1,1,55
Lone Tree Golf Course,Douglas,9808 Sunningdale Blvd,3,10,13,43
Longhorn Steakhouse,Adams,100 E 120th Ave,1,4,5,51
Longhorn Steakhouse,Arapahoe,9625 E County Line Rd,3,7,10,46
Longshot Lounge,Arapahoe,3665 S Federal Blvd,8,4,12,44
Loras Donuts and Bakery Shop,Douglas,11804 E Oswego St Unit A,5,3,8,48
Los 3 Garcias Mexican Food,Adams,5175 W 68th Ave,3,4,7,49
Los Alcatraces,Arapahoe,2295 S Chambers Rd Unit A,5,5,10,46
Los Arcos,Douglas,9045 Forsstrom Dr,9,5,14,42
Los Arcos Express,Adams,1612 W 92nd Ave,7,6,13,43
Los Arcos Mexican Restaurant,Adams,4991 W 80th Ave,0,0,0,56
Los Dos Potrillos Highlands Ranch,Douglas,35 Springer Dr,2,3,5,51
Los Dos Potrillos Mexican,Arapahoe,8251 S Holly St,2,4,6,50
Los Dos Potrillos Parker,Douglas,19340 Cottonwood Dr,1,4,5,51
Los Fraire Nieveria,Adams,8020 Federal Blvd Unit 3,1,4,5,51
Los Jimadores,Adams,275 S 4th Ave,6,11,17,39
Los Nogales Restaurant Inc,Adams,8919 Washington St,8,4,12,44
Los Portales Mexican Restaurant,Arapahoe,3483 S Logan St,7,4,11,45
Los Sierras Bar,Adams,6762 Lowell Blvd,0,1,1,55
Los Tamales,Adams,4952 E 62nd Ave Unit A7,7,6,13,43
Los Tonys Mexican Restaurant,Adams,10202 E Montview Blvd,7,11,18,38
Los Toritos Restaurant 2,Arapahoe,9405 E Colfax Ave,7,3,10,46
Lost Cajun Restaurant,Adams,3013 W 104th Ave,2,4,6,50
Lost Cajun The,Arapahoe,5350 S Santa Fe Dr Unit F,4,7,11,45
Lost Cajun The,Arapahoe,6105 S Main St Ste F-104,7,6,13,43
Lost Coffee,Adams,2100 N Ursula St Unit 30,2,1,3,53
Lost Coffee,Douglas,390 Perry St,2,5,7,49
Lotus Chinese Kitchen,Adams,1261 W 84th Ave,6,9,15,41
Lotus School For Excellence,Arapahoe,11001 E Alameda Ave Ste A,0,0,0,56
Louis Diner,Arapahoe,1500 W Littleton Blvd Unit 100,11,11,22,34
Loves Shack,Adams,7290 Pecos St,2,3,5,51
Loves Travel Stop Country Store,Adams,1191 S 1st St,4,3,7,49
Lowell Mart,Adams,6855 Lowell Blvd,1,1,2,54
Lowes 117,Adams,7305 Pecos St,3,7,10,46
Lowes Mercado,Adams,10777 E Colfax Ave,10,7,17,39
Loyal Order of Moose Lodge 2166,Adams,11449 York St,4,2,6,50
LuBos N Y Pizza,Arapahoe,15352 E Ida Dr,0,2,2,54
Luceros Tavern,Adams,10339 N Federal Blvd # 300,1,5,6,50
Luceros and Sons Inc,Adams,5201 Pecos St,2,5,7,49
Luciles,Arapahoe,2852 W Bowles Ave,3,4,7,49
Lucky Express,Adams,11970 Washington St,2,2,4,52
Lucky Lanes,Adams,1850 E Bridge St,4,4,8,48
Lulus Inn,Adams,33355 E Highway 36,6,11,17,39
Lunch Wired,Arapahoe,12201 E Arapahoe Rd Unit C3,2,3,5,51
Lyn Knoll Elementary,Arapahoe,12445 E 2nd Ave,0,0,0,56
M Mart,Arapahoe,2000 S Havana St,2,3,5,51
M Meat Mart,Arapahoe,2000 S Havana St # F,3,2,5,51
M and J Restaurant (2),Arapahoe,26000 E Quincy Ave,5,9,14,42
MAC,Adams,3295 W 72nd Ave,0,1,1,55
MC Gas and Food,Arapahoe,1305 S Zante St,3,3,6,50
MEC Mesa School,Adams,8980 York St,0,1,1,55
MS Sushi - King Soopers,Arapahoe,6000 S Holly St,0,0,0,56
Maandeeq Restaurant and Cafe,Arapahoe,1535 S Havana St,5,5,10,46
Mad Greens,Adams,1181 W 120th Ave,2,6,8,48
Mad Greens,Arapahoe,7300 E Arapahoe Rd,1,1,2,54
Mad Greens,Arapahoe,8283 S Akron St Ste 130,4,8,12,44
Mad Greens,Douglas,10002 Commons St Ste E2,2,6,8,48
Mad Greens,Douglas,1525 Park Central Dr Ste 100E,0,1,1,55
Mad Greens,Douglas,4991 Factory Shops Blvd Ste 100,2,3,5,51
Mad Greens 119,Arapahoe,23973 E Prospect Ave,1,4,5,51
Mad Greens 120,Douglas,8401 Park Meadows Center Dr Unit DH-8,1,8,9,47
Mad Greens 7,Arapahoe,4948 S Yosemite St Unit B,1,2,3,53
Madinah Inc,Arapahoe,3126 S Parker Rd,3,2,5,51
Madrid Event Center,Adams,6495 Monaco St,4,3,7,49
Maggianos Little Italy,Arapahoe,7401 S Clinton St,2,8,10,46
Main Event Entertainment LP,Douglas,64 Centennial Blvd,4,1,5,51
Main Street Cafe,Adams,161 N Main St,8,7,15,41
Mairik Adult Day Care,Arapahoe,7255 S Havana St Unit 130,2,4,6,50
Majestic Sports Bar and Restaurant,Arapahoe,3140 S Parker Rd Ste 1,6,6,12,44
Makizushico,Arapahoe,5950 S Platte Canyon Rd Unit D23,2,0,2,54
Makola African Market,Adams,2020 Clinton St Ste B,3,2,5,51
Malley Elementary,Adams,1300 Malley Dr,0,1,1,55
Mama Alvinos Pizzeria,Adams,15179 E Colfax Ave Unit A,5,8,13,43
Mama Louise Italian Restaurant,Arapahoe,15412 E Orchard Rd,2,5,7,49
Mama Mias,Arapahoe,3531 S Logan St Unit G,7,5,12,44
Mama Olivias,Arapahoe,477 Sable Blvd,1,3,4,52
Mama Roma Pasta and Pizza,Arapahoe,8100 S Quebec St Unit B16,6,4,10,46
Mama Sol Cocina,Arapahoe,6439 S Broadway Unit B,4,2,6,50
Mamas Cafe,Adams,6025 E Parkway Dr Ste 160,9,7,16,40
Mambo Cafe Inc,Adams,790 W 84th Ave,2,5,7,49
Mammoth Heights/ Elementary,Douglas,9500 Stonegate Pkwy,0,1,1,55
Mangia Bevi,Arapahoe,6363 S Fiddlers Green Cir,2,0,2,54
Manheim Cafe,Arapahoe,17500 E 32nd Ave,6,11,17,39
Manna Bakery and Deli,Arapahoe,6905 S Broadway Unit 61,3,1,4,52
Manna Best,Arapahoe,11000 E Yale Ave Ste 226,7,3,10,46
Mapleton Global Leadership Academy 912,Adams,7480 N Broadway Bldg 2,0,0,0,56
Marcos Coal Fired Pizza,Arapahoe,10111 Inverness Main St Ste J,7,8,15,41
Marcos Pizza,Adams,12899 Quebec St,4,4,8,48
Marcos Pizza,Adams,14663 Orchard Pkwy Ste 100,5,4,9,47
Marcos Pizza,Arapahoe,21699 E Quincy Ave Unit G,1,3,4,52
Marcos Pizza 6014,Arapahoe,24300 E Smoky Hill Rd 114,2,3,5,51
Maria Empanada,Arapahoe,8000 E Belleview Ave Unit B30,1,0,1,55
Maria Empanada at the Stanley Marketplace,Arapahoe,2501 N Dallas St,2,1,3,53
Maries Dulceria and Sweets,Adams,3901 E 112th Ave Unit A,6,7,13,43
Mariscos El Pelicano,Adams,15355 E Colfax Ave Unit E2,6,14,20,36
Mariscos El Rey,Arapahoe,820 Dayton St,9,5,14,42
Mariscos El Rey 2,Arapahoe,10293 E Iliff Ave,4,5,9,47
Mark Hopkins Elementary,Arapahoe,7171 S Pennsylvania St,1,0,1,55
Mark Twain Elementary,Arapahoe,6901 S Franklin St,0,0,0,56
Marketplace,Douglas,3235 Mill Vista Rd,1,0,1,55
Marriott Denver Airport Hotel,Adams,16455 E 40th Cir,4,7,11,45
Marriott Denver South,Douglas,10345 Park Meadows Dr,6,6,12,44
Marriott Fairfield Inn & Suites Westminster,Adams,12080 Melody Dr,2,2,4,52
Martinezs,Arapahoe,1228 W Littleton Blvd,3,0,3,53
Marys Pescaderia,Adams,3133 Peoria St Unit 203,2,2,4,52
Masalaa,Arapahoe,3140 S Parker Rd Unit 8,4,6,10,46
Masha and The Bear Russian Cafe,Arapahoe,12101 E Iliff Ave Ste M,3,4,7,49
Massinos Pizza and Pasta,Arapahoe,1250 S Buckley Rd Unit A,3,2,5,51
Massinos Pizzeria,Adams,6813 Lowell Blvd,5,2,7,49
Maverik,Adams,11160 E Colorado Blvd,0,0,0,56
Maverik,Adams,8810 Pecos St,2,2,4,52
Maverik,Arapahoe,15510 E 6th Ave,3,0,3,53
Maverik,Arapahoe,22910 E Arapahoe Rd,3,0,3,53
Maverik,Arapahoe,3755 N Chambers Rd,4,1,5,51
Maverik,Douglas,3991 Limelight Ave,3,4,7,49
Maverik 525,Arapahoe,13480 E Mississippi Ave,3,2,5,51
Maverik Store 579,Arapahoe,21800 E Quincy Ave,2,1,3,53
May Farms,Arapahoe,64001 E Highway 36,7,6,13,43
Mc Donalds - Belleview 11360,Arapahoe,5090 S Quebec St,1,3,4,52
McCarthys Sports Bar and Grill,Arapahoe,15350 E Smoky Hill Rd,4,4,8,48
McDonalds,Adams,1191 S 1st St,2,4,6,50
McDonalds,Adams,3151 Airport Blvd,2,4,6,50
McDonalds,Adams,5155 W 72nd Ave,1,3,4,52
McDonalds,Adams,5990 Dahlia St,2,1,3,53
McDonalds,Adams,611 E 120th Ave,3,3,6,50
McDonalds,Adams,7400 Federal Blvd,1,2,3,53
McDonalds,Adams,9190 Federal Blvd,2,5,7,49
McDonalds,Adams,9901 Grant St,2,2,4,52
McDonalds,Arapahoe,1444 S Havana St,0,3,3,53
McDonalds,Arapahoe,19893 E Smoky Hill Rd,4,4,8,48
McDonalds,Arapahoe,3601 S Federal Blvd,1,0,1,55
McDonalds,Arapahoe,5858 S Santa Fe Dr,1,3,4,52
McDonalds,Arapahoe,6101 S Aurora Pkwy,2,1,3,53
McDonalds,Arapahoe,630 W Hampden Ave,2,0,2,54
McDonalds,Arapahoe,6686 S Yosemite Ct,2,1,3,53
McDonalds,Arapahoe,8241 S Holly St,1,5,6,50
McDonalds,Arapahoe,9400 E Hampden Ave,1,1,2,54
McDonalds,Douglas,4999 Factory Shops Blvd,1,4,5,51
McDonalds,Douglas,9160 Crown Crest Blvd,0,1,1,55
McDonalds,Douglas,9235 S Broadway,0,3,3,53
McDonalds #35381,Adams,15251 E 104th Ave,0,1,1,55
McDonalds 13682,Adams,5750 Washington St,1,2,3,53
McDonalds 19091,Arapahoe,10555 E Briarwood Cir,2,5,7,49
McDonalds 20427,Arapahoe,6462 S Parker Rd,0,3,3,53
McDonalds 22588,Arapahoe,18181 E Hampden Ave,1,3,4,52
McDonalds 25575,Arapahoe,2700 W Belleview Ave,0,2,2,54
McDonalds 2878,Adams,8700 Washington St,2,1,3,53
McDonalds 33159,Adams,10400 Belle Creek Blvd,3,0,3,53
McDonalds 37454,Arapahoe,4000 S Parker Rd,1,2,3,53
McDonalds 5369,Adams,895 S Kuner Rd,2,4,6,50
McDonalds 5560,Arapahoe,16891 E Iliff Ave,2,3,5,51
McDonalds 5562,Adams,6050 Parkway Dr,0,3,3,53
McDonalds 6727,Arapahoe,1050 S Chambers Rd,2,1,3,53
McDonalds 7120,Adams,14251 E Colfax Ave,0,3,3,53
McDonalds 7367,Arapahoe,16890 E Quincy Ave,5,2,7,49
McDonalds Lone Tree 21390,Douglas,9800 S Yosemite St,0,0,0,56
McDonalds Quebec 18783,Douglas,8667 S Quebec St,1,0,1,55
McDonalds Restaurant,Adams,10195 Washington St,0,1,1,55
McDonalds Restaurant,Adams,12875 Quebec St,2,7,9,47
McDonalds Restaurant,Adams,2750 W 104th Ave,2,3,5,51
McDonalds Restaurant,Adams,3690 E 104th Ave,3,4,7,49
McDonalds Restaurant,Adams,3994 E 120th Ave,1,7,8,48
McDonalds Restaurant,Adams,599 W 104th Ave,3,5,8,48
McDonalds Restaurant,Arapahoe,12900 E Mississippi Ave,2,1,3,53
McDonalds Restaurant,Arapahoe,14201 E 6th Ave,2,3,5,51
McDonalds Restaurant,Arapahoe,2651 S Parker Rd,2,2,4,52
McDonalds Restaurant,Douglas,10011 Jordan Rd,0,4,4,52
McDonalds Restaurant,Douglas,10950 S Parker Rd,1,3,4,52
McDonalds Restaurant 24890,Adams,2171 W 128th Ave,2,5,7,49
McDonalds Restaurant 31627,Adams,200 W 136th Ave,2,5,7,49
McDonalds Restaurant 34804,Adams,770 W 84th Ave,1,3,4,52
McDonalds Restaurant 37116,Arapahoe,25650 E Arapahoe Rd,3,1,4,52
McDonalds Restaurant BR 2,Adams,2017 Prairie Center Pkwy,2,3,5,51
McDonalds of Castle Rock,Douglas,995 Park St,2,5,7,49
McDonalds of Littleton,Arapahoe,6300 S Broadway,0,1,1,55
McDonalds of Littleton,Arapahoe,8011 S Broadway,1,1,2,54
McDonoughs Restaurant,Arapahoe,10395 E Iliff Ave,3,4,7,49
McElwain Elementary,Adams,1020 Dawson Dr,0,0,0,56
McKinners Pizza Bar,Arapahoe,2389 W Main St,3,3,6,50
Meadow Elementary,Adams,9150 Monroe St,0,1,1,55
Meadow Point Elementary,Arapahoe,17901 E Grand Ave,0,0,0,56
Meadow View Elementary,Douglas,3700 Butterfield Crossing Dr,0,0,0,56
Meadows 12 at the Entertainment Dist,Douglas,9355 Park Meadows Dr,0,0,0,56
Meat Truck Jones BBQ Catering,Arapahoe,15473 E Hampden Ave,1,0,1,55
Medical Center of Aurora North Campus,Arapahoe,700 Potomac St,2,6,8,48
Medical Center of Aurora South Campus,Arapahoe,1501 S Potomac St Dept 800,0,2,2,54
Megenagna Grocery,Arapahoe,306 S Ironton St Unit C,3,3,6,50
Mei Wei,Adams,6075 E Parkway Dr Ste 105,1,2,3,53
Melting Pot The,Arapahoe,2707 W Main St,5,7,12,44
Menchies Frozen Yogurt,Adams,1001 W 120th Ave Ste 110,0,0,0,56
Menchies Frozen Yogurt,Adams,14643 Orchard Pkwy Unit 200,2,3,5,51
Mendozas Juice and Ice Cream Bar,Adams,9265 Washington St,4,3,7,49
Menuderia Y Taqueria Chihuas,Adams,6185 E 72nd Ave,7,2,9,47
Menya Sushi Bar,Arapahoe,5910 S University Blvd Unit B1,5,4,9,47
Mercado Azteca,Adams,9701 Montview Blvd,9,9,18,38
Mercedes Mexican Restaurant,Adams,11165 Irma Dr,1,1,2,54
Mercedes Mexican Restaurant,Adams,6940 Pecos St,3,2,5,51
Mercury Event Center,Adams,3006 W 72nd Ave,3,1,4,52
Meridian Cafe,Douglas,9601 S Meridian Blvd,3,7,10,46
Meridian Golf Course,Douglas,9742 S Meridian Blvd,7,5,12,44
Mesa Elementary,Adams,9100 Lowell Blvd,2,0,2,54
Mesa Middle School,Douglas,365 N Mitchell St,0,1,1,55
Meskerem Restaurant,Arapahoe,1121 S Peoria St,4,8,12,44
Mesquite Grill,Arapahoe,9668 E Arapahoe Rd,5,8,13,43
Metabolic Kitchen,Adams,12348 E Montview Blvd,3,1,4,52
Metapan Restaurante,Adams,11707 E Colfax Ave,7,6,13,43
Metropolitan Bar and Grill,Arapahoe,10111 Inverness Main St Unit H,8,9,17,39
Mi Cocina,Arapahoe,1600 W Belleview Ave,4,2,6,50
Mi Cocina Express,Arapahoe,137 W County Line Rd,7,3,10,46
Mi Pueblo Latin Market,Adams,15855 E Colfax Ave,6,11,17,39
Mi Pueblo Latin Market,Adams,6941 E 80th Ave,13,13,26,30
Mi Pueblo Latin Market,Adams,9171 Washington St,3,3,6,50
Mi Pueblo Ranch Market 8,Adams,6040 E 64th Ave,4,3,7,49
Mi Ranchito Neveria,Adams,11922 Washington St,2,0,2,54
Mias Pizza and Pasta,Arapahoe,8931 E Union Ave,4,0,4,52
Mici Hand Crafted Italian,Douglas,9245 S Broadway Unit 800,2,3,5,51
Mici Italian Restaurant,Douglas,11290 S Twenty Mile Rd Ste 121,2,4,6,50
Mick Mullens,Arapahoe,3467 S Broadway,1,3,4,52
Mickeys Express,Adams,7770 Highway 2,2,1,3,53
Mickeys Top Sirloin,Adams,6950 Broadway,2,8,10,46
Mics Craft Kitchen,Arapahoe,7531 E Iliff Ave,5,6,11,45
Mika Sushi 2,Adams,10343 Federal Blvd Unit H,12,8,20,36
Mikes Cafe,Arapahoe,4110 S Federal Blvd,9,13,22,34
Milano Coffee,Arapahoe,9602 E Arapahoe Rd,2,2,4,52
Mile High Cafe,Douglas,2975 Summer Wind Ln,1,0,1,55
Mile High Catering,Arapahoe,8035 S Quebec St,2,1,3,53
Mile High Flea Market-L Street Bar,Adams,7007 E 88th Ave,0,0,0,56
Mile High Halal,Arapahoe,7950 E Mississippi Ave Unit E,5,2,7,49
Mile High Pizza,Arapahoe,1010 S Peoria St,3,3,6,50
Mile High Pupusas,Arapahoe,2504 W Hampden Ave,3,3,6,50
Mile High Smokehouse,Arapahoe,9555 E Arapahoe Rd Unit 12,4,8,12,44
Milkroll Creamery,Arapahoe,2712 S Havana St Unit A,0,0,0,56
Mimis Cafe,Adams,14416 Delaware St,5,9,14,42
Mimis Cafe,Arapahoe,205 S Abilene St,5,3,8,48
Mimis Cafe,Douglas,9155 Park Meadows Dr,3,3,6,50
Mings Dynasty,Arapahoe,4251 E Mississippi Ave,4,3,7,49
Mini Food Store,Arapahoe,4696 S Federal Blvd,3,1,4,52
Mis Cafe,Arapahoe,17455 E Exposition Dr,5,4,9,47
Misaki at Stanley,Arapahoe,2501 N Dallas St Unit 184,6,5,11,45
Mission Viejo Elementary,Arapahoe,3855 S Alicia Pkwy,0,1,1,55
Mixing Bowl Cookie Dough,Arapahoe,5580 S Parker Rd,0,1,1,55
Miyako Ra-Men Noodle Restaurant,Arapahoe,2950 S Broadway Unit,6,3,9,47
Miyo Cafe,Douglas,858 W Happy Canyon Rd Ste 110,9,8,17,39
Mod Pizza,Arapahoe,23890 Smoky Hill Rd,0,1,1,55
Mod Pizza,Douglas,3622 E Highlands Ranch Pkwy Unit 101,0,3,3,53
Mod Pizza,Douglas,4989 Factory Shops Blvd Unit 240,2,4,6,50
Mod Pizza - 425,Arapahoe,18300 Cottonwood Dr Ste 111,1,1,2,54
Mod Super Fast Pizza,Arapahoe,8225 S Chester St Unit 103,1,2,3,53
Modern Brew,Arapahoe,8221 S Holly St,5,0,5,51
Modern Market,Arapahoe,1000 S Colorado Blvd,0,2,2,54
Modern Market,Arapahoe,3475 S University Blvd,6,3,9,47
Modern Market,Arapahoe,6955 S York St Unit 423,2,1,3,53
Modern Market,Arapahoe,8575 E Arapahoe Rd Unit,0,2,2,54
Modern Market,Douglas,537 W Highlands Ranch Pkwy Unit 108,1,2,3,53
Moes Original Bar B Que,Arapahoe,3295 S Broadway,2,2,4,52
Mojo Ethiopian Coffee and Grocery,Arapahoe,15256 E Hampden Ave,3,4,7,49
Molcajete,Arapahoe,1911 S Havana St,4,5,9,47
Monaco Elementary,Adams,7631 Monaco St,0,2,2,54
Monaco Food Store,Adams,5990 Monaco St,1,0,1,55
Monaghans Bar & Grill,Arapahoe,3889 S King St,6,5,11,45
Mondo Market,Arapahoe,2501 N Dallas St,4,2,6,50
Monk and Mongoose,Douglas,9580 Ridgegate Pkwy,1,4,5,51
Monsoon Restaurant,Arapahoe,24107 E Commons Ave Ste 105,3,3,6,50
Monterey Elementary,Adams,2201 Mcelwain Blvd,0,0,0,56
Montessori Warming Kitchen,Arapahoe,15503 E Mississippi Ave Ste B,0,1,1,55
Montview Elementary,Adams,2055 Moline St,1,1,2,54
Moomoos,Arapahoe,14200 E Alameda Ave,0,0,0,56
Moonshine Bar,Adams,119 N Main St,2,5,7,49
Moose Hill Brighton,Adams,839 S Kuner Rd,1,6,7,49
Mountain Range DECA,Adams,12500 Huron St,0,0,0,56
Mountain Ridge Middle School,Douglas,10590 Mountain Vista Rdg,0,0,0,56
Mountain View Elementary School,Douglas,8502 N Pinery Pkwy,0,0,0,56
Mountain Vista Elementary,Arapahoe,22200 E Radcliff Pkwy,1,0,1,55
Mountain Vista High School,Douglas,10585 Mountain Vista Rdg,1,2,3,53
Movie Tavern,Arapahoe,18605 E Hampden Ave,9,5,14,42
Moze Cafe,Douglas,10375 Park Meadows Dr # 160,2,2,4,52
Mozzy D Stores,Arapahoe,754 Peoria St,2,9,11,45
Mr Donuts,Arapahoe,1704 S Chambers Rd,4,1,5,51
Mr Egg,Adams,7310 Washington St,3,1,4,52
Mr Kim Korean BBQ,Arapahoe,12201 E Mississippi Ave Unit 113,3,3,6,50
Mr Panda Buffet,Arapahoe,2852 S Havana St,4,5,9,47
Mr Pollo,Adams,2961 W 72nd Ave,3,3,6,50
Mr Ramen,Douglas,9328 S Jordan Rd Unit 105,3,0,3,53
Mrachek Middle School,Arapahoe,1955 S Telluride St,0,2,2,54
Mt Fuji Hibachi,Adams,14643 Orchard Pkwy Unit 100,7,6,13,43
Mt Fuji Hibachi & Sushi,Douglas,18260 Lincoln Ave Ste 101,6,6,12,44
Mt Fuji Hibachi Restaurant,Arapahoe,6100 S Main St Unit H101,6,6,12,44
Mt Fuji Japanese Cuisine II Inc,Douglas,4714 Milestone Ln Unit H,6,9,15,41
Munch A Sub,Arapahoe,116 Inverness Dr E Ste 100,2,2,4,52
Murphy Creek Grill,Arapahoe,1700 S Old Tom Morris Rd,5,1,6,50
Murphy Creek K thru 8,Arapahoe,1400 S Old Tom Morris Rd,0,0,0,56
Murphy Express,Adams,8799 Brighton Rd,3,2,5,51
Murphy Express,Douglas,13001 Copperhead Trl,1,0,1,55
Murphy Express 8587,Adams,3470 Tower Rd,4,8,12,44
Murphy Express 8732,Adams,14375 Lincoln St,3,2,5,51
Murphy Oil,Adams,12820 Oneida St,1,2,3,53
Muse Noraebang Cafe,Arapahoe,2222 S Havana St,3,1,4,52
My Cafe,Arapahoe,14200 E Alameda Ave,2,1,3,53
My Cafe,Douglas,2240 Mercantile St Ste 100,3,4,7,49
My Favorite Muffin,Arapahoe,1627 S Havana St,0,3,3,53
My Favorite Muffin and Bagel Cafe,Arapahoe,12201 E Arapahoe Rd Unit B12,3,6,9,47
My Favorite Muffin and Bagel Cafe,Arapahoe,8719 E Dry Creek Rd Unit B,1,4,5,51
My Goods Market 6521,Adams,160 W 104th Ave,3,1,4,52
My Goods Market 6536,Adams,12780 Colorado Blvd,2,7,9,47
My Goods Market 6544,Douglas,9215 E Lincoln Ave,1,3,4,52
My Salad Chop,Arapahoe,12201 E Arapahoe Rd Unit A1,2,2,4,52
NGL Burgers,Arapahoe,382 S Chambers Rd,5,1,6,50
NY Bagel Cafe and Deli,Arapahoe,9555 E Arapahoe Rd Unit 16,10,4,14,42
Naan Curry Grill,Arapahoe,10639 E Briarwood Ave Ste A2,10,9,19,37
Nana African Market,Arapahoe,10223 E Iliff Ave,4,8,12,44
Nancys Cafe,Adams,7120 Federal Blvd,4,6,10,46
Nanuri Prentice Cafe,Arapahoe,8101 E Prentice Ave Ste 250,2,2,4,52
Native Foods Cafe,Arapahoe,680 S Colorado Blvd,2,2,4,52
Natural Grocers by Vitamin Cottage,Adams,11465 Washington St,1,1,2,54
Natural Grocers by Vitamin Cottage,Douglas,1265 Sgt Jon Stiles Dr Ste M,0,3,3,53
Natural Grocers by Vitamin Cottage,Douglas,4510 Trail Boss Dr,2,1,3,53
Natures Table,Arapahoe,7475 S Joliet St,3,5,8,48
Nazar International Market and Deli,Arapahoe,1842 S Parker Rd Unit 6,3,2,5,51
Nekter Juice Bar,Douglas,3620 E Highlands Ranch Pkwy Unit 103,0,0,0,56
Nepali Mountain Kitchen,Arapahoe,10180 E Colfax Ave Ste 180,3,0,3,53
Neveria Jedanys,Arapahoe,12132 E Mississippi Ave,3,2,5,51
Neveria La Unica,Arapahoe,10 S Havana St Unit 119,5,3,8,48
Neveria La Zumba,Adams,110 W 70th Ave,2,1,3,53
Neveria Sabor Latino,Arapahoe,1462 Iola St,7,5,12,44
New America School,Adams,8978 N Washington St,2,2,4,52
New America School,Arapahoe,9125 E 7th Pl Bldg 905,4,2,6,50
New Canton BBQ,Arapahoe,2751 S Parker Rd Unit B,4,6,10,46
New China City,Arapahoe,10300 E Colfax Ave,11,9,20,36
New Day Cafe,Arapahoe,5001 S Parker Rd Ste 115,3,2,5,51
New Dynasty,Douglas,16522 Keystone Blvd Unit A,5,6,11,45
New Indian Cafe,Arapahoe,6886 S Clinton St,9,13,22,34
New Nagoya Hibachi Express,Arapahoe,10761 E Alameda Ave Unit B,6,10,16,40
New York Bakery,Arapahoe,10720 E Iliff Ave,2,3,5,51
Newks Eatery,Douglas,10012 Commons St Unit 100,3,4,7,49
Next Door American Eatery,Adams,14345 Orchard Pkwy,5,2,7,49
Nicks Garden Center Cafe,Arapahoe,2001 S Chambers Rd,1,2,3,53
Nicolos Chicago Style Pizza,Douglas,9463 S University Blvd,6,7,13,43
Night Shift Saloon,Arapahoe,3095 S Peoria St Unit B,7,10,17,39
Nile Ethiopian Restaurant,Arapahoe,1951 S Havana St,9,9,18,38
Nixons Coffee House,Arapahoe,6115 S Santa Fe Dr,2,0,2,54
Nixons Coffee House,Arapahoe,871 Englewood Pkwy,5,5,10,46
Nixtamale Tortilla Bakery,Arapahoe,12028 E Mississippi Ave Unit F2,6,1,7,49
No Cow Cafe,Douglas,206 Fifth St,4,0,4,52
No Nos Cafe,Arapahoe,3005 W County Line Rd,6,5,11,45
No Que No Authentic Mexican Kitchen,Adams,9271 Washington St,7,5,12,44
Nom Nom Asian Grill,Arapahoe,13700 E Colfax Ave Unit I,4,3,7,49
Nonnas Italian Bistro Market & Deli,Arapahoe,11877 E Arapahoe Rd Unit B,5,7,12,44
Noodles & Company,Arapahoe,4590 Leetsdale Dr,0,1,1,55
Noodles & Company 170,Adams,14375 Orchard Pkwy Unit 600,5,2,7,49
Noodles and Company,Adams,10355 Federal Blvd Unit H,1,5,6,50
Noodles and Company,Adams,3450 N Tower Rd,4,4,8,48
Noodles and Company,Arapahoe,10550 E Garden Dr Ste 106,0,2,2,54
Noodles and Company,Arapahoe,12023 E Arapahoe Rd Ste 100,0,1,1,55
Noodles and Company,Arapahoe,13700 E Colfax Ave,1,2,3,53
Noodles and Company,Arapahoe,6200 S Main St Ste 101,1,2,3,53
Noodles and Company,Arapahoe,7301 S Santa Fe Dr Unit 320,0,5,5,51
Noodles and Company,Arapahoe,8000 E Belleview Ave Unit A20,0,0,0,56
Noodles and Company,Douglas,11153 S Parker Rd,1,2,3,53
Noodles and Company,Douglas,1601 Mayberry Dr Ste 104,2,4,6,50
Noodles and Company,Douglas,34 E Allen St Ste 400,1,4,5,51
Noodles and Company,Douglas,9400 Heritage Hills Cir,0,4,4,52
Noodles and Company,Douglas,9563 S University Blvd,1,6,7,49
Noodles and Company 132,Arapahoe,697 W Hampden Ave Unit A,0,1,1,55
Noodles and Company 138,Arapahoe,4261 S Buckley Rd,1,4,5,51
Noodles and Company 139,Arapahoe,2370 E Arapahoe Rd Unit 926,2,4,6,50
Noodles and Company 163,Adams,3824 E 120th Ave # B,2,8,10,46
Noodles and Company 173,Douglas,17051 E Lincoln Ave Unit N,0,2,2,54
Noonans Sports Bar,Arapahoe,13521 E Iliff Ave,3,7,10,46
Nordstrom Espresso Bar,Douglas,8465 Park Meadows Center Dr,2,8,10,46
North Denver Sausage Deli,Adams,7626 N Washington St,4,1,5,51
North Elementary,Adams,89 N Sixth Ave,1,3,4,52
North Middle School,Adams,12095 Montview Blvd,0,2,2,54
North Mor Elementary,Adams,9580 Damon Dr,0,0,0,56
North Suburban Medical Center,Adams,9191 Grant St,2,2,4,52
Northeast Elementary,Adams,1605 Longs Peak St,1,2,3,53
Northeast Elementary,Douglas,6598 N Highway 83,0,3,3,53
Northgate Taphouse and Event Center,Arapahoe,3880 S Lowell Blvd,1,1,2,54
Northglenn American Legion Post 22,Adams,11081 Irma Dr,3,3,6,50
Northglenn Elks Lodge 2438,Adams,10969 Irma Dr,7,3,10,46
Northglenn High School,Adams,601 W 100th Pl,1,1,2,54
Northglenn Middle School,Adams,1123 Muriel Dr,0,0,0,56
Northridge Elementary,Douglas,555 Southpark Rd,0,0,0,56
Northstar Academy,Douglas,16700 Keystone Blvd,1,1,2,54
Northstar Elementary,Adams,8740 Northstar Dr,0,1,1,55
Northwest Aerie Order of Eagles 4019,Adams,8800 Federal Blvd,5,4,9,47
Nothing Bundt Cakes,Arapahoe,23973 E Prospect Ave Ste B,1,1,2,54
Nothing Bundt Cakes,Douglas,7508 Parkway Dr Ste 200,0,1,1,55
Nourish Meals on Wheels,Arapahoe,92 E Arapahoe Rd,2,0,2,54
Nova Catering,Adams,8301 Rosemary St,3,4,7,49
Now Pho II,Arapahoe,1500 W Littleton Blvd Unit 110-A,7,6,13,43
O Briens Cafe,Douglas,5585 Highway 85,5,10,15,41
OPA Grill,Douglas,18366 Lincoln Ave Unit 101,3,5,8,48
Oasis Grill,Arapahoe,15064 E Mississippi Ave,6,4,10,46
Obok Zip,Arapahoe,2720 S Havana St Ste H,2,3,5,51
Ocean Prime,Arapahoe,8000 E Belleview Ave Unit C10,2,2,4,52
Odds on OTB,Adams,5390 Sheridan Blvd,1,0,1,55
Off Broadway Cafe Perfect Setting Catering,Adams,6810 Broadway,4,4,8,48
Office Co The,Douglas,230 3rd St,9,9,18,38
Ohana Cafe,Arapahoe,7951 E Maplewood Ave Ste 123,4,1,5,51
Okinawa Sushi,Adams,11985 Washington St Unit 2,4,3,7,49
Okinawa Sushi,Douglas,9231 E Lincoln Ave Unit 1100,3,4,7,49
Old Blinking Light,Douglas,9344 Dorchester St Ste 104,2,5,7,49
Old Chicago,Adams,10180 Grant St,4,3,7,49
Old Chicago,Adams,2155 Prairie Center Pkwy,3,5,8,48
Old Chicago,Adams,3909 E 120th Ave,3,5,8,48
Old Chicago,Arapahoe,16990 E Iliff Ave,3,5,8,48
Old Chicago,Arapahoe,6676 S Parker Rd,1,2,3,53
Old Chicago,Douglas,1489 Park Central Dr Bldg G,3,6,9,47
Old Chicago 0067,Arapahoe,6105 S Main St,3,6,9,47
Old Chicago Pizza and Taproom,Arapahoe,3840 River Point Pkwy,2,1,3,53
Old Fashioned Italian Deli,Arapahoe,395 W Littleton Blvd Unit,4,5,9,47
Old Santa Fe Express Mexican Grill,Arapahoe,5501 S Broadway,6,6,12,44
Old Santa Fe Mexican Grill,Douglas,11465 S Twenty Mile Rd,5,4,9,47
Old West Bar B Que,Douglas,107 Wolfensberger Rd,4,5,9,47
Olde Towne Tavern,Arapahoe,2410 W Main St,6,6,12,44
Olive Garden 1714,Arapahoe,6089 S Southlands Pkwy,2,3,5,51
Olive Garden 329,Douglas,2520 E County Line Rd,2,3,5,51
Olive Garden Italian Restaurant 1250,Arapahoe,2390 S Havana St,3,6,9,47
Olive Garden Italian Restaurant 1593,Adams,1151 E 120th Ave,7,6,13,43
On The Border,Douglas,8555 S Quebec St,2,4,6,50
On The Rox Sports Bar & Grill,Douglas,11957 Lioness Way,5,8,13,43
On the Border Mexican Grill and Cantina,Arapahoe,6369 S Southlands Pkwy,5,4,9,47
One Barrel,Arapahoe,3401 S Broadway,2,1,3,53
Options Secondary Program at Whitman,Arapahoe,6557 S Acoma St,0,0,0,56
Orange Julius Dairy Queen,Arapahoe,14200 E Alameda Ave Ste 2060A,1,1,2,54
Orchid Asian Bistro,Arapahoe,1140 W Littleton Blvd,7,8,15,41
Oriental Cafe,Douglas,549 W Highlands Ranch Pkwy,4,5,9,47
Original Hamburger Stand,Adams,8680 Washington St,3,0,3,53
Original Hamburger Stand The 82,Arapahoe,3100 S Broadway,1,2,3,53
Original Pancake House,Arapahoe,5900 S University Blvd Ste D,0,4,4,52
Original Pancake House,Arapahoe,8000 E Belleview Ave Unit F10,0,1,1,55
Oumi Sushi at Sprouts 301,Adams,5150 W 120th Ave,0,1,1,55
Oumi Sushi at Sprouts 309,Douglas,10018 Commons St,0,0,0,56
Oumi Sushi at Sprouts 325,Arapahoe,5001 S Broadway,1,0,1,55
Our Place Bar,Adams,7320 Pecos St,4,7,11,45
Out Post Bar,Adams,6921 Lowell Blvd,1,1,2,54
Outback Steakhouse 0615,Adams,497 E 120th Ave,4,5,9,47
Outback Steakhouse 0618,Arapahoe,10443 E Costilla Ave,3,3,6,50
Outback Steakhouse 0619,Arapahoe,2066 S Abilene St,1,4,5,51
Outback Steakhouse 0626,Douglas,4687 Milestone Ln,4,5,9,47
Outback Steakhouse 614,Douglas,15 Springer Dr,1,1,2,54
Outpost,Douglas,7431 Park Meadows Dr,0,0,0,56
Overland High School,Arapahoe,12400 E Jewell Ave,0,0,0,56
Overland Trail Middle School,Adams,455 N 19th Ave,1,4,5,51
Overseas Oriental Market,Adams,7141 Irving St Ste D,0,4,4,52
P F Changs China Bistro,Arapahoe,23902 E Prospect Ave,4,2,6,50
P F Changs China Bistro,Douglas,8315 Park Meadows Center Dr,7,9,16,40
P and G Concessionaire,Adams,300 Strong St,0,2,2,54
P and Y Cafe,Arapahoe,2769 S Parker Rd,3,5,8,48
P-8 at APS Community Campus,Arapahoe,55 N Salida Way,0,0,0,56
Pacific Ocean Marketplace,Arapahoe,12303 E Mississippi Ave Unit 135,2,7,9,47
Padre,Arapahoe,8035 S Quebec St,0,2,2,54
Palateria La Michoacan,Arapahoe,697 Peoria St,4,7,11,45
Palenque Cocina Y Agaveria,Arapahoe,2609 W Main St,4,8,12,44
Paleteria La Loteria,Adams,1418 W 104th Ave,1,2,3,53
Paleteria y Neveria La Flor de Michoacan,Adams,6326 Ivy St,3,0,3,53
Palleteria La Michoacana,Adams,827 Kuner Rd,4,4,8,48
Panache Catering/Two Penguins,Arapahoe,13065 E Briarwood Ave,10,8,18,38
Panaderia Contreras 2,Adams,10777 E Colfax Ave,5,5,10,46
Panaderia Tlaquepaque,Arapahoe,2300 S Chambers Rd Unit L,3,4,7,49
Panaderia Y Antojitos La Piramide,Adams,2425 E 88th Ave,11,3,14,42
Panaderia Y Tortilleria LyLy,Adams,1550 W 70th Ave,5,6,11,45
Panaderia y Pasteleria Moreno,Adams,10247 E Colfax Ave,7,2,9,47
Panda Buffet,Adams,8460 Federal Blvd,7,8,15,41
Panda Buffet,Arapahoe,12597 E Mississippi Ave Unit 100,2,5,7,49
Panda Express,Adams,3586 Eagle Blvd,1,3,4,52
Panda Express,Adams,891 S Kuner Rd,2,1,3,53
Panda Express,Arapahoe,14302 E Cedar Ave Unit A,1,3,4,52
Panda Express,Arapahoe,3425 Salida St Unit A,0,3,3,53
Panda Express,Arapahoe,5350 S Santa Fe Dr Unit H,0,0,0,56
Panda Express,Arapahoe,5670 S Chambers Rd,1,0,1,55
Panda Express,Douglas,8515 Park Meadows Center Dr Unit 3033,1,2,3,53
Panda Express,Douglas,9563 S University Blvd,0,1,1,55
Panda Express 1085,Arapahoe,16891 E Quincy Ave,0,3,3,53
Panda Express 1317,Adams,2680 W 104th Ave,3,8,11,45
Panda Express 1360,Arapahoe,2990 S Broadway,1,1,2,54
Panda Express 1515,Douglas,8331 Willow St Unit A,1,0,1,55
Panda Express 2890,Adams,550 E 144th Ave,3,0,3,53
Panda Express 3114,Adams,15481 E 104th Ave,2,2,4,52
Panda Express 686,Douglas,11153 S Parker Rd Unit D,0,4,4,52
Panda Express 711,Adams,901 E 120th Ave Unit A,2,1,3,53
Panda Express 721,Arapahoe,9500 E Hampden Ave Unit D,0,2,2,54
Panda Garden Chinese Restaurant,Adams,9682 Washington St,6,7,13,43
Panera Bread,Arapahoe,23950 Smoky Hill Rd,4,2,6,50
Panera Bread,Douglas,35 E Allen St,1,3,4,52
Panera Bread 2420,Arapahoe,12293 E Iliff Ave,1,3,4,52
Panera Bread 2441,Arapahoe,6770 S Cornerstar Way Unit E,2,1,3,53
Panera Bread 2444,Arapahoe,640 S Colorado Blvd,2,4,6,50
Panera Bread 3064,Douglas,9579 S University Blvd,0,7,7,49
Panera Bread 3066,Arapahoe,5910 S Holly St,2,0,2,54
Panera Bread 3068,Arapahoe,7301 S Santa Fe Dr,2,0,2,54
Panera Bread 3072,Douglas,9233 Park Meadows Dr,0,3,3,53
Panera Bread 3086,Arapahoe,3702 River Point Pkwy Unit A,2,4,6,50
Panera Bread 3093,Arapahoe,13100 E Colfax Ave Unit 60,3,1,4,52
Panera Bread 3103,Adams,100 E 120th Ave,2,3,5,51
Panera Bread 3105,Adams,14415 Delaware St,2,4,6,50
Panera Bread Cafe 3084,Douglas,11290 S Twenty Mile Rd Ste 123,0,4,4,52
Papa Johns Pizza,Adams,10401 Belle Creek Blvd Ste 102,6,4,10,46
Papa Johns Pizza,Adams,126 W Bridge St,3,2,5,51
Papa Johns Pizza,Douglas,390 S Wilcox St Ste E,3,6,9,47
Papa Johns Pizza 1040,Adams,7245 Pecos St,2,3,5,51
Papa Johns Pizza 1044,Arapahoe,15493 E Hampden Ave Unit E,4,4,8,48
Papa Johns Pizza 1052,Arapahoe,5194 S Broadway,4,0,4,52
Papa Johns Pizza 1055,Adams,5160 W 120th Ave,3,7,10,46
Papa Johns Pizza 1057,Douglas,9245 S Broadway Unit 400,2,4,6,50
Papa Johns Pizza 1455,Arapahoe,580 S Chambers Rd,6,3,9,47
Papa Johns Pizza 1466,Douglas,9227 E Lincoln Ave Ste 400,2,1,3,53
Papa Johns Pizza 1473,Douglas,10641 Park Glenn Way,4,5,9,47
Papa Johns Pizza 1474,Arapahoe,8655 E Arapahoe Rd,1,0,1,55
Papa Johns Pizza 1477,Arapahoe,20941 E Smoky Hill Rd Unit A,1,0,1,55
Papa Johns Pizza 4258,Arapahoe,10551 E Garden Dr Ste 104,2,0,2,54
Papa Johns Pizza 4639,Adams,880 E 88th Ave Unit 130,4,3,7,49
Papa Mazzottis,Adams,2252 Lake Ave,6,5,11,45
Papa Murphys,Adams,2690 W 104th Ave,1,5,6,50
Papa Murphys,Douglas,13029 S Parker Rd,2,2,4,52
Papa Murphys,Douglas,9231 E Lincoln Ave Ste 1000,2,5,7,49
Papa Murphys,Douglas,9559 S University Blvd Unit 103,3,5,8,48
Papa Murphys CO 025,Arapahoe,8575 E Arapahoe Rd Unit D,2,0,2,54
Papa Murphys Highlands Ranch,Douglas,9315 Dorchester St Unit G108,2,0,2,54
Papa Murphys Pizza,Adams,96 N 50th Ave Unit A,0,2,2,54
Papa Murphys Pizza CO 008,Arapahoe,12158 E Mississippi Ave,0,0,0,56
Papa Murphys Pizza CO 010,Arapahoe,15440 E Hampden Ave,2,2,4,52
Papa Murphys Pizza CO 106,Arapahoe,1180 S Buckley Rd Unit C,1,1,2,54
Papa Murphys Take N Bake,Arapahoe,25791 E Smoky Hill Rd Unit 90,1,2,3,53
Papa Murphys Take N Bake Pizza,Adams,15165 E 104th Ave,3,3,6,50
Papa Murphys Take N Bake Pizza,Arapahoe,7408 S University Blvd,1,1,2,54
Papa Murphys Take N Bake Pizza CO 030,Adams,3782 E 104th Ave Ste D,4,4,8,48
Papa Murphys Take N Bake Pizza CO 105,Adams,13691 Colorado Blvd Ste 103,3,3,6,50
Papa Nickys Pizza and Wings,Arapahoe,12203 E Iliff Ave Ste T,6,3,9,47
Papa Ricks Pizza,Arapahoe,3112 S Parker Rd Unit G,5,3,8,48
Papas Pizza,Adams,5765 Washington St,4,3,7,49
Pappadeaux Seafood Kitchen,Arapahoe,7520 E Progress Pl,1,5,6,50
Papusas La Salvadorena,Arapahoe,304 Havana St,7,2,9,47
Paradise Asian Cafe,Arapahoe,6180 S Gun Club Rd Unit L1,8,12,20,36
Paragon Dining Service,Arapahoe,500 Airport Blvd,2,1,3,53
Paragon Food Services atCCA,Arapahoe,16000 E Centretech Pkwy,4,5,9,47
Paris Elementary,Adams,1635 Paris St,0,2,2,54
Park Centre Lounge,Adams,12011 Pecos St,1,4,5,51
Park Lane Elementary,Adams,13001 E 30th Ave,2,3,5,51
Parker Adventist Hospital,Douglas,9395 Crown Crest Blvd,0,5,5,51
Parker Dairy Queen,Douglas,19102 E Plaza Dr,2,4,6,50
Parker Food and Gas,Arapahoe,3116 S Parker Rd,4,2,6,50
Parker Garage,Douglas,19420 E Mainstreet,1,6,7,49
Parker Gas & Snack,Douglas,11411 S Twenty Mile Rd Unit 100,1,3,4,52
Parker Performing Arts School,Douglas,15035 Compark Blvd,0,0,0,56
Parker Schoolhouse at Mainstreet,Douglas,19650 E Mainstreet,0,0,0,56
Parker Senior Center,Douglas,10675 Longs Way,3,3,6,50
Parker Valley Hope,Douglas,22422 E Main St,4,3,7,49
Parkside Village Retirement,Arapahoe,14501 E Crestline Dr,7,3,10,46
Parkway Bar and Grill,Arapahoe,22775 E Aurora Pkwy Unit C8,3,3,6,50
Parkway Cafe,Adams,1762 W 92nd Ave,5,7,12,44
Parrys,Douglas,9567 S University Blvd Unit B2,5,6,11,45
Parrys Pizza,Arapahoe,2154 E Commons Ave Ste 300,4,2,6,50
Parrys Pizza,Douglas,12501 E Lincoln Ave Unit 101,3,5,8,48
Parrys Pizza,Douglas,5650 Allen Way Ste 119,4,7,11,45
Parrys Pizzeria,Adams,100 E 120th Ave Unit F110,2,8,10,46
Parrys Pizzeria & Bar IV,Arapahoe,5970 S Holly St,5,3,8,48
Pastries N Chaat,Douglas,7824 Park Meadows Dr Ste 300,6,7,13,43
Pats Philly Steaks and Subs,Arapahoe,7419 E Iliff Ave,3,5,8,48
Patter Bar,Adams,12189 N Pennsylvania St,0,0,0,56
Patxis Pizza,Arapahoe,3455 S University Blvd Unit B,5,4,9,47
Peabody Elementary,Arapahoe,3128 E Maplewood Ave,0,0,0,56
Peak Refreshments,Arapahoe,20556 E 32nd Pkwy,1,3,4,52
Peak Refreshments,Arapahoe,6465 Greenwood Plaza Blvd,0,0,0,56
Peak to Peak Tap Room,Arapahoe,16701 E Iliff Ave,4,4,8,48
Peaks The,Arapahoe,16510 E Hughes Dr Bldg S79,3,1,4,52
Peakview Coffee,Arapahoe,620 Southpark Dr,4,2,6,50
Pearl of Siam,Arapahoe,18660 E Hampden Ave,7,9,16,40
Peets Coffee and Tea,Arapahoe,6751 S York St Ste 518,2,1,3,53
Pegasus Restaurant,Douglas,313 Jerry St,5,6,11,45
Pei Wei Asian Diner,Douglas,9352 S Colorado Blvd # 1G,3,8,11,45
Pennock K thru 8 School,Adams,3707 Estrella St,1,0,1,55
Penthouse Club,Arapahoe,4451 E Virginia Ave,2,2,4,52
Peoria Elementary,Arapahoe,875 Peoria St,1,1,2,54
Peppinos Pizza,Arapahoe,14200 E Alameda Ave Unit 1039A,3,3,6,50
Perfect Landing Restaurant,Arapahoe,7625 S Peoria St,3,4,7,49
Perks Cafe,Douglas,1500 Park Central Dr Room G 101,1,1,2,54
Perry Park Country Club,Douglas,7047 Perry Park Blvd Unit RR1,5,6,11,45
Perrys Steakhouse and Grille,Douglas,8433 Park Meadows Center Dr Unit D154,4,5,9,47
Persnicke Tea,Douglas,200 Perry St,1,2,3,53
Perspective Gourmet,Arapahoe,1670 N Jasper St Unit H,2,1,3,53
Petes Cafe,Adams,9170 Washington St,4,3,7,49
Petroleum Wholesale 6525 Gas Station,Adams,1695 N Watkins Rd,2,10,12,44
Phillips 66,Adams,2651 E 120th Ave,3,1,4,52
Phillips 66,Adams,9200 Federal Blvd,1,1,2,54
Phillips 66,Douglas,9160 Crown Crest Blvd,1,3,4,52
Pho 104,Adams,421 W 104th Ave Ste H,5,7,12,44
Pho 15,Adams,665 E 70th Ave,3,5,8,48
Pho 4 Mua Vietnam Cuisine,Adams,9866 Grant St,4,3,7,49
Pho 4 U,Arapahoe,3610 River Point Pkwy Unit C,8,2,10,46
Pho 5,Douglas,363 Village Square Ln Ste 130,5,8,13,43
Pho 7,Adams,3917 E 120th Ave,8,4,12,44
Pho 75,Arapahoe,13736 E Quincy Ave,3,2,5,51
Pho 75 Havana,Arapahoe,2050 S Havana St,3,1,4,52
Pho 777,Arapahoe,562 S Chambers Rd Unit 18,5,4,9,47
Pho 777,Douglas,323 Metzler Dr Ste 106,7,5,12,44
Pho 79,Adams,3049 W 74th Ave Unit B,3,7,10,46
Pho 81,Adams,275 Pavilions Pl Unit F,8,4,12,44
Pho 88,Adams,10250 Federal Blvd Ste 700,4,4,8,48
Pho 888,Arapahoe,539 Sable Blvd,5,5,10,46
Pho 90,Arapahoe,23955 E Plaza Ave Unit G 115,5,6,11,45
Pho 95 Noodle House and Grill,Arapahoe,6879 S Vine St Ste 714,8,6,14,42
Pho 97,Arapahoe,16748 E Smoky Hill Rd Unit 9A,6,8,14,42
Pho 99,Arapahoe,1080 S Havana St,3,3,6,50
Pho 99,Arapahoe,211 E County Line Rd,7,11,18,38
Pho Bowlevard,Arapahoe,5950 S Platte Canyon Rd Unit A1,8,7,15,41
Pho Broadway,Arapahoe,6645 S Broadway,2,7,9,47
Pho By Night,Douglas,9234 Park Meadows Dr Ste 100,1,0,1,55
Pho Cafe Asian Cuisine,Arapahoe,12405 E Mississippi Ave Unit 200,2,6,8,48
Pho Duy III,Arapahoe,680 Peoria St,10,15,25,31
Pho Ever Yum,Adams,13691 Colorado Blvd Unit 121,5,5,10,46
Pho Khang II,Arapahoe,8283 S Akron St Unit 140,6,3,9,47
Pho Kim,Arapahoe,12203 E Iliff Ave Ste H,7,1,8,48
Pho Kimmie,Adams,2841 W 120th Ave Unit C100,6,3,9,47
Pho Le 2,Arapahoe,2719 S Parker Rd,5,5,10,46
Pho Lee,Adams,14643 Orchard Pkwy Ste 400,6,2,8,48
Pho Lee,Arapahoe,6860 S Clinton St Unit C,4,2,6,50
Pho Peoria,Arapahoe,1695 Peoria St,5,5,10,46
Pho Real,Arapahoe,2399 W Main St,10,9,19,37
Pho Saigon,Adams,12033 Pecos St,5,6,11,45
Pho Saigon Denver,Arapahoe,7585 E Iliff Ave,4,10,14,42
Pho Saigon Vietnamese Noodle and Grill,Arapahoe,9555 E Arapahoe Rd Unit 1,5,5,10,46
Pho TJ,Adams,702 E Bridge St,4,10,14,42
Pho Vy,Arapahoe,6770 S Cornerstar Way Unit,12,11,23,33
Pho Vy,Douglas,18366 Lincoln Ave Unit 109,6,11,17,39
Piassa Ethio Mart,Arapahoe,12028 E Mississippi Ave Unit A,4,6,10,46
Piccino Wood Oven Pizza,Arapahoe,5350 S Santa Fe Dr Unit A,2,1,3,53
Pickens Perk,Arapahoe,500 Airport Blvd Bldg A,1,2,3,53
Pie Society Pizza,Arapahoe,4615 E Mississippi Ave,0,0,0,56
Piezanos,Douglas,5457 Manhart St,0,5,5,51
Pily Cafe,Adams,8501 Grant St,6,2,8,48
Pine Grove Elementary,Douglas,10450 Stonegate Pkwy,0,0,0,56
Pine Lane Intermediate School,Douglas,6475 E Ponderosa Dr,0,0,0,56
Pine Lane Primary Elementary,Douglas,6475 Ponderosa Dr,0,0,0,56
Pine Ridge Elementary,Arapahoe,6525 S Wheatlands Pkwy,0,0,0,56
Pinery Country Club - Main Clubhouse,Douglas,6900 N Pinery Pkwy,5,4,9,47
Pinnacle Charter School,Adams,1001 W 84th Ave,2,4,6,50
Pinnacle High School,Adams,8412 Huron St,3,1,4,52
Pinocchios 4,Adams,177 E Bridge St,3,7,10,46
Pinos,Arapahoe,1400 E Hampden Ave Unit 140,5,5,10,46
Pinos Italian Kitchen & Bar,Douglas,361 Village Square Ln,5,7,12,44
Pint Room,Arapahoe,2620 W Belleview Ave,3,2,5,51
Pioneer Elementary,Douglas,10881 Riva Ridge St,0,2,2,54
Piper Inn,Arapahoe,2251 S Parker Rd,5,5,10,46
Pisco Sour,Arapahoe,14050 E Evans Ave,4,5,9,47
Pita Pit,Adams,1181 W 120th Ave Unit 200,1,3,4,52
Pitchers,Arapahoe,1670 S Chambers Rd,6,9,15,41
Pizza Hut,Adams,11975 N Holly St,0,3,3,53
Pizza Hut,Adams,7352 Washington St,0,1,1,55
Pizza Hut,Douglas,9068 Forsstrom Dr Ste C15,1,0,1,55
Pizza Hut 035000,Douglas,10535 S Parker Rd,1,6,7,49
Pizza Hut 035001,Douglas,340 S Wilcox St,0,6,6,50
Pizza Hut 4822,Adams,14601 E Colfax Ave Unit C,2,2,4,52
Pizza Hut 4823,Arapahoe,1545 S Havana St,2,4,6,50
Pizza Hut 4824,Arapahoe,16800 E Iliff Ave,1,0,1,55
Pizza Hut 4825,Arapahoe,5657 S Himalaya St Ste 260,0,5,5,51
Pizza Hut 4826,Arapahoe,1086 S Sable Blvd,3,2,5,51
Pizza Hut 4827,Arapahoe,18187 E Hampden Ave,0,3,3,53
Pizza Hut 4829,Adams,2210 E Bridge St,3,2,5,51
Pizza Hut 4832,Arapahoe,5270 E Arapahoe Rd Unit G3,1,3,4,52
Pizza Hut 4833,Adams,6125 E Parkway Dr,2,4,6,50
Pizza Hut 4839,Arapahoe,9500 E Hampden Ave,1,1,2,54
Pizza Hut 4842,Adams,7171 Pecos St,1,4,5,51
Pizza Hut 4849,Arapahoe,4100 S Broadway,1,3,4,52
Pizza Hut 4851,Arapahoe,10639 E Briarwood Ave Ste B1,1,3,4,52
Pizza Hut 4859,Douglas,9385 S Colorado Blvd Unit 106,0,4,4,52
Pizza Hut 4860,Arapahoe,5856 S Lowell Blvd Ste 30,0,5,5,51
Pizza Hut 4861,Arapahoe,7960 S Broadway,3,2,5,51
Pizza Hut 4863,Adams,11920 Washington St,2,3,5,51
Pizza Hut 4866,Adams,13762 Colorado Blvd Unit 100,2,5,7,49
Pizza Hut 4867,Adams,3880 E 104th Ave,0,2,2,54
Pizza Hut 4868,Adams,7820 Sheridan Blvd,0,2,2,54
Pizza Hut 4869,Adams,12049 Pecos St,1,3,4,52
Pizza Hut 4871,Adams,10343 Federal Blvd Unit C,0,4,4,52
Pizza Hut 4873,Adams,15550 E 103rd Pl Unit 100,1,3,4,52
Pizza Pit Stop,Adams,56551 E Colfax Ave,3,1,4,52
Pizza Republica,Arapahoe,5375 Landmark Pl Ste 113,6,2,8,48
Platte River Bar and Grill,Arapahoe,5995 S Santa Fe Dr,10,10,20,36
Platte Valley Medical Center,Adams,1600 Prairie Center Pkwy,1,6,7,49
Players Club,Adams,6710 Federal Blvd,5,4,9,47
Plentea,Adams,1391 E 120th Ave Ste D,5,5,10,46
Plum Creek Academy,Douglas,9340 Commerce Center St,0,0,0,56
Plum Creek Catering,Douglas,1605 Park St Unit D,3,6,9,47
Plum Creek Golf Club,Douglas,331A Players Club Dr,2,1,3,53
Poke Bowl,Douglas,10981 S Parker Rd,8,6,14,42
Poke City,Arapahoe,1128 S Colorado Blvd,2,1,3,53
Poke City,Arapahoe,3401 S Broadway Ste 120,5,1,6,50
Poke City,Arapahoe,8547 E Arapahoe Rd Unit K,2,0,2,54
Poke Co,Arapahoe,91 W Mineral Ave Unit 140,8,9,17,39
Poke Concept,Arapahoe,14302 E Cedar Ave Unit B,4,3,7,49
Poke Concept,Arapahoe,9555 E Arapahoe Rd Unit 10,4,2,6,50
Poke One,Douglas,9227 E Lincoln Ave Ste 500,6,5,11,45
Poke Story 1 The,Arapahoe,23955 E Plaza Dr Unit G 103,3,2,5,51
Poke Story II,Arapahoe,2330 E Arapahoe Rd Ste 903,1,2,3,53
Pokecity,Arapahoe,6750 S Cornerstar Way Unit D,1,1,2,54
Pollo Lima,Arapahoe,9614 E Arapahoe Rd,5,9,14,42
Pollo Picante 10498,Arapahoe,10498 E Colfax Ave Unit E,7,6,13,43
Polton Elementary,Arapahoe,2985 S Oakland St,0,0,0,56
Ponchos Mexican Grill,Arapahoe,5350 S Santa Fe Dr Unit C,8,9,17,39
Ponderosa Elementary,Arapahoe,1885 S Lima St,0,1,1,55
Ponderosa High School,Douglas,7007 E Bayou Gulch Rd,0,3,3,53
Popcorn Bliss,Douglas,6360 Promenade Pkwy Unit 130,1,0,1,55
Popeyes,Adams,5101 Quebec St,0,4,4,52
Popeyes 401,Adams,12051 Huron St,2,5,7,49
Popeyes 406,Adams,15199 E Colfax Ave,8,6,14,42
Popeyes 410,Arapahoe,3122 S Parker Rd,3,4,7,49
Popeyes 411,Adams,11097 E Colfax Ave,1,4,5,51
Popeyes 412,Adams,550 W 84th Ave,3,4,7,49
Popeyes 416,Douglas,1340 New Beale St,5,7,12,44
Popeyes 418,Adams,15050 E 104th Ave,3,3,6,50
Popeyes Chicken,Arapahoe,22998 E Smoky Hill Rd,0,1,1,55
Popeyes Chicken 413,Adams,6450 Sheridan Blvd,1,3,4,52
Popeyes Louisiana Chicken,Adams,9711 Washington St,3,1,4,52
Popeyes Louisiana Kitchen 427,Adams,2032 Prairie Center Pkwy,0,3,3,53
Popeyes Louisianna Kitchen 424,Arapahoe,2150 S Quebec St,3,3,6,50
Pork Chop King,Arapahoe,34501 E Quincy Ave,5,1,6,50
Portofino Pizza and Pasta,Douglas,10920 S Parker Rd Unit B9,4,5,9,47
Posh Pastries,Douglas,10471 S Parker Rd Ste 8B,5,9,14,42
Potbelly Sandwich Shop,Adams,14306 Lincoln St,2,1,3,53
Potbelly Sandwich Shop,Douglas,1341 New Beale St Ste 100,1,4,5,51
Potbelly Sandwich Shop,Douglas,8475 S Yosemite St Ste A,3,6,9,47
Powell Middle School,Arapahoe,8000 S Corona Way,0,0,0,56
Practice Facilities Building Driving Range,Adams,9650 Sheridan Blvd,0,0,0,56
Pradera Golf Club,Douglas,5225 Raintree Dr,6,4,10,46
Prairie Crossing Elementary,Douglas,11605 S Bradbury Ranch Dr,0,4,4,52
Prairie Hill Elementary,Adams,13801 Garfield Pl,0,2,2,54
Prairie Middle School,Arapahoe,12600 E Jewell Ave,0,1,1,55
Prairie View High School,Adams,12909 E 120th Ave,0,1,1,55
Prairie View Middle School,Adams,12915 E 120th Ave,1,1,2,54
Prana Inc,Adams,3645 W 112th Ave,0,0,0,56
Primal Axe House,Arapahoe,3545 S Platte River Dr Unit M1,0,1,1,55
Primos Italian,Adams,7174 Washington St Unit A,6,2,8,48
Products By Mahoney Limited,Adams,12189 Pennsylvania St,0,0,0,56
Profile by Sanford,Arapahoe,8575 E Arapahoe Rd Unit G,0,0,0,56
Pudge Bros Pizza,Arapahoe,4034 S Parker Rd,4,4,8,48
Pudge Brothers Pizza,Adams,6085 E 64th Ave,1,0,1,55
Pudger Enterprises,Douglas,650 Perry Park Ave,1,2,3,53
Pupusas Paradise,Arapahoe,15462 E Hampden Ave # E,7,7,14,42
Purgatory Cellars,Douglas,30 W Springer Dr,2,0,2,54
Purgatory Cellars,Douglas,611 N Wilcox St Unit C,0,0,0,56
Q Rico Mexican Food,Arapahoe,14200 E Alameda Ave Unit 2015,4,3,7,49
Qdoba Mexican Grill 1717,Douglas,955 New Memphis Ct Ste 103,1,6,7,49
Qdoba Mexican Grill 2003,Arapahoe,5188 S Broadway,2,2,4,52
Qdoba Mexican Grill 2006,Arapahoe,1156 S Colorado Blvd,2,6,8,48
Qdoba Mexican Grill 2063,Adams,1005 W 120th Ave Ste 100,2,4,6,50
Qdoba Mexican Grill 2065,Arapahoe,2295 S Peoria St,5,7,12,44
Qdoba Mexican Grill 2085,Arapahoe,800 Englewood Pkwy Unit C100,2,2,4,52
Qdoba Mexican Grill 2088,Arapahoe,7301 S Santa Fe Dr Unit 210,1,2,3,53
Qdoba Mexican Grill 2094,Douglas,9364 S Colorado Blvd Unit C10,0,2,2,54
Qdoba Mexican Grill 2120,Douglas,11215 S Parker Rd,1,4,5,51
Qdoba Mexican Grill 2134,Arapahoe,1180 S Buckley Rd Unit A,1,3,4,52
Qdoba Mexican Grill 2239,Douglas,9338 S Dorchester St,1,2,3,53
Qdoba Mexican Grill 2245,Adams,275 Pavilions Pl Unit A,2,6,8,48
Qdoba Mexican Grill 2252,Arapahoe,7465 E Arapahoe Rd,1,0,1,55
Qdoba Mexican Grill 2270,Arapahoe,23923 E Prospect Ave Unit C,1,2,3,53
Qdoba Mexican Grill 2272,Arapahoe,10909 E Arapahoe Pl Unit A1,3,5,8,48
Qdoba Mexican Grill 2329,Douglas,78 E Allen St,1,4,5,51
Qdoba Mexican Grill 2419,Adams,10018 Grant St,1,6,7,49
Qdoba Mexican Grill 2478,Arapahoe,16270 E Arapahoe Rd Unit,4,5,9,47
Qdoba Mexican Grill 2537,Arapahoe,10550 E Garden Dr Ste 101,0,2,2,54
Qdoba Mexican Grill 2538,Arapahoe,6703 S University Blvd Ste 936,3,1,4,52
Qdoba Mexican Grill 2595,Douglas,8441 S Yosemite St Ste 6,1,4,5,51
Qdoba Mexican Grill 2604,Douglas,9994 Commons St Ste 210,3,5,8,48
Qdoba Mexican Grill 2914,Adams,3804 E 120th Ave,4,3,7,49
Qera Ethiopian Meat Market,Arapahoe,1030 Havana St,9,6,15,41
Qomo Farms,Adams,12189 Pennsylvania St,1,0,1,55
Quality Inn,Adams,8500 Turnpike Dr,1,0,1,55
Quality Inn and Suites,Adams,3300 Ouray St,2,4,6,50
Quality Inn and Suites-Comfort Inn and Suites,Douglas,10535 El Diente Ct,2,1,3,53
Quiznos,Adams,2237 Prairie Center Pkwy Unit E,2,6,8,48
Quiznos,Arapahoe,8775 E Orchard Rd Unit 801,1,1,2,54
Quiznos #6751,Adams,8426 Pearl St,0,0,0,56
Quiznos 23,Arapahoe,8053 S Broadway,2,2,4,52
Quiznos Sub,Arapahoe,18880 E Hampden Ave,5,3,8,48
RB Food and Gas LLC,Adams,11010 E 120th Ave,2,4,6,50
RCH By Cup,Adams,10601 Reunion Pkwy,0,1,1,55
RORO Juice,Arapahoe,2514 E Arapahoe Rd,2,0,2,54
Radisson Hotel Denver Southeast,Arapahoe,3155 S Vaughn Way,7,15,22,34
Rail Pub The,Douglas,11800 E Oswego St Unit D10,4,4,8,48
Rainbow Center,Adams,690 W 84th Ave,1,1,2,54
Raising Canes,Douglas,5012 Founders Pkwy,1,0,1,55
Raising Canes 277,Douglas,18200 E Cottonwood Dr,0,1,1,55
Raising Canes 310,Arapahoe,6645 S Parker Rd,0,0,0,56
Raising Canes Chicken Fingers,Arapahoe,14241 E Alameda Ave,1,0,1,55
Raising Canes Chicken Fingers,Douglas,1108 Cpl Max Donahue Ln,1,0,1,55
Raleigh House of Hope,Arapahoe,325 Almstead Rd,2,0,2,54
Ralph Moody Elementary,Arapahoe,6390 S Windermere St,0,0,0,56
Ramada Plaza Damons La Fondue,Adams,10 E 120th Ave,4,8,12,44
Ranch Country Club,Adams,11887 Tejon St,5,7,12,44
Ranch View Middle School,Douglas,1731 W Wildcat Reserve Pkwy,0,1,1,55
Rancho Alegre,Adams,8411 Pecos St,5,7,12,44
Rancho Alegre Mexican Restaurant,Arapahoe,420 S Chambers Rd Unit B,16,11,27,29
Rangeview High School Cafeteria,Arapahoe,17599 E Iliff Ave,1,0,1,55
Ranum Middle School,Adams,2401 W 80th Ave,0,2,2,54
Real De Minas Mexican Grill II,Arapahoe,14035 E Evans Ave,2,3,5,51
Real Food Ready,Adams,12189 Pennsylvania St,0,1,1,55
Real de Minas III,Arapahoe,15795 E Briarwood Cir,5,0,5,51
Real de Minas Mexican Grill III,Arapahoe,6775 S Cornerstar Way Unit E,2,6,8,48
Red Hawk Ridge Elementary,Arapahoe,16251 E Geddes Ave,1,4,5,51
Red Hawk Ridge Golf Clubhouse,Douglas,2156 Red Hawk Ridge Dr,5,6,11,45
Red Lion Inn and Suites Denver Airport,Adams,16921 E 32nd Ave,7,4,11,45
Red Lobster 0118,Arapahoe,10854 E Alameda Ave,1,4,5,51
Red Lobster 6215,Douglas,9067 Westview Rd,4,10,14,42
Red Lobster 6334,Arapahoe,6139 S Southlands Pkwy,6,2,8,48
Red Lobster0328,Adams,1350 W 104th Ave,2,6,8,48
Red Robin Americas Gourmet Burgers,Adams,799 W 146th Ave,3,1,4,52
Red Robin Burger and Spirits Emporium,Douglas,8355 Park Meadows Center Dr,4,4,8,48
Red Robin Burgers and Spirits Emporium,Arapahoe,8585 E Arapahoe Rd,0,3,3,53
Red Robin Burgers and Spirits Emporium,Douglas,63 Centennial Blvd,1,3,4,52
Red Robin Gourmet Burger and Spirit Emporium,Arapahoe,1491 S Havana St,3,0,3,53
Red Robin Gourmet Burgers,Arapahoe,6795 S Cornerstar Way,0,3,3,53
Red Robin Gourmet Burgers,Douglas,46 E Allen St,0,3,3,53
Red Robin Gourmet Burgers University,Arapahoe,10000 E Geddes Ave Unit 500,2,3,5,51
Red Robin Gourmet Burgers and Brews,Adams,2021 Prairie Center Pkwy,4,3,7,49
Red Robin Gourmet Burgers and Spirits,Douglas,9130 Crown Crest Blvd,3,3,6,50
Red Rooster,Adams,5761 Washington St,2,2,4,52
Redstone Elementary,Douglas,9970 Glenstone Cir,0,3,3,53
Refresh Cafe,Douglas,1024 Park Meadows Dr,2,0,2,54
Regal Cinebarre Greenwood Plaza,Arapahoe,8141 E Arapahoe Rd,3,0,3,53
Regis Jesuit High School Girls Division,Arapahoe,6300 S Lewiston Way,1,2,3,53
Relish This,Arapahoe,11350 E Orchard Rd,1,2,3,53
Renaissance Magnet School,Douglas,3960 Trail Boss Ln,0,0,0,56
Renaissance Secondary School,Douglas,3954 Trail Boss Ln,0,0,0,56
Rendezvous Restaurant,Arapahoe,2888 S Heather Gardens Way Ste 3,3,4,7,49
Renegade Burrito,Adams,10005 Grant St Unit E,1,4,5,51
Renzios Greek Food,Douglas,8401 Park Meadows Center Dr Unit 2415,7,8,15,41
Residence Inn,Douglas,3090 W County Line Rd,6,5,11,45
Residence Inn by Marriott,Arapahoe,16490 E 40th Cir,2,4,6,50
Residence Inn by Marriott,Douglas,8322 S Valley Hwy,2,3,5,51
Retired Enlisted Association Inc,Adams,1599 Dayton St,5,4,9,47
Reunion Elementary School,Adams,11021 Landmark Dr,0,0,0,56
Revolution Foods,Adams,6360 E 58th Ave Unit H,1,0,1,55
Rica Pizza,Adams,8868 Federal Blvd Unit 16A,1,5,6,50
Ricardo Flores Magon Academy Inc,Adams,5301 Lowell Blvd,0,1,1,55
Riccos Burritos,Adams,7794 Washington St,1,0,1,55
Rice Bistro and Sushi,Arapahoe,5922 S Holly St,6,9,15,41
Rice Bistro and Sushi,Arapahoe,7301 S Santa Fe Dr Unit 410,2,4,6,50
Rice Bowl,Adams,7592 Highway 2,0,5,5,51
Rico Pollo,Adams,1824 W 92nd Ave,2,7,9,47
Rico Pollo,Adams,9075 E Colfax Ave,6,7,13,43
Rico Pollo,Adams,9862 Grant St,3,2,5,51
Rico Pollo 4,Adams,5790 E 64th Ave,5,2,7,49
Ridge at Castle Pines North The,Douglas,1414 W Castle Pines Pkwy,3,5,8,48
Riize Coffee,Arapahoe,8200 Southpark Cir Unit B,1,2,3,53
Ringcentral 4th Floor Prep Kitchen,Arapahoe,8005 S Chester St 4 Fl,2,4,6,50
Rio Grande Mexican Restaurant,Douglas,9535 Park Meadows Dr Unit A,1,5,6,50
Rise Pies Pizza,Adams,13801 Grant St Ste 503,4,5,9,47
Ritas Italian Ice & Creamery 1303,Douglas,3990 Limelight Ave D,0,2,2,54
Ritas Italian Ice Parker,Douglas,19250 E Lincoln Ave Ste 120,0,1,1,55
River Bottom Restaurant,Adams,75 W Bridge St,7,12,19,37
Riverdale Elementary,Adams,10724 Elm Dr,0,0,0,56
Riverdale Restaurant,Adams,13300 Riverdale Rd,7,8,15,41
Riverdale Ridge High School,Adams,13360 Yosemite St,1,2,3,53
Riverpointe Retirement Facility,Arapahoe,5225 S Prince St,1,0,1,55
Roberto Gomez Pizza and Burritos,Adams,806 E 78th Ave,2,3,5,51
Roberts Deli,Arapahoe,6380 S Fiddlers Green Cir Unit 109C,1,1,2,54
Robusto Room The,Douglas,9535 Park Meadows Dr Unit D-2,3,2,5,51
Rock Bottom Brewery,Arapahoe,9627 E County Line Rd,4,10,14,42
Rock Bottom Restaurant & Brewery,Douglas,1505 Park Central Dr,3,1,4,52
Rock Canyon High School,Douglas,5810 McArthur Ranch Rd,0,2,2,54
Rock Restaurant and Bar The,Arapahoe,22934 E Smoky Hill Rd,1,2,3,53
Rock Ridge Elementary,Douglas,400 N Heritage Rd,0,2,2,54
Rock The,Douglas,4881 Cherokee Dr,1,4,5,51
Rock Wood Fired Pizza and Spirits,Douglas,53 Centennial Blvd,5,1,6,50
Rocky Heights Middle School,Douglas,11033 Monarch Blvd,0,2,2,54
Rocky Mountain Catering,Douglas,10525 El Diente Ct,1,1,2,54
Rocky Mountain Chocolate Factory,Douglas,5050 Factory Shops Blvd Ste 820,0,0,0,56
Rocky Mountain Chocolate Factory 50681,Arapahoe,6240 S Main St Ste 102,3,1,4,52
Rocky Mountain Elementary,Adams,3350 W 99th Ave,0,6,6,50
Rocky Mountain Multiple Sclerosis Center,Adams,8845 Wagner St,2,3,5,51
Rocky Mountain Pizzeria,Douglas,19523 Hess Rd,4,4,8,48
Rocky Top Middle School 10,Adams,14150 York St,0,0,0,56
Rockyard Brewing Company,Douglas,880 W Castleton Rd,0,0,0,56
Rojas Mexican Restaurant,Adams,710 W 120th Ave,4,0,4,52
Rolling Hills Elementary,Arapahoe,5756 S Biscay St,0,1,1,55
Rolling Smoke BBQ,Arapahoe,2501 N Dallas St,3,2,5,51
Rolling Smoke BBQ,Arapahoe,7470 S University Blvd Unit A1,3,1,4,52
Romancing the Bean,Arapahoe,5800 S Prince St,4,1,5,51
Romanos Pizzeria,Arapahoe,5666 S Windermere St,1,7,8,48
Romos Street Tacos,Douglas,221 Perry St,1,1,2,54
Rookies,Arapahoe,1323 Monroe St,2,1,3,53
Rorys Diner,Douglas,11020 S Pikes Peak Dr Ste 150,3,3,6,50
Rosa Mexican Kitchen,Douglas,8361 N Rampart Range Rd,2,2,4,52
Rose Hill Elementary,Adams,6900 E 58th Ave,0,0,0,56
Rosenbergs Bagels,Arapahoe,2501 Dallas St,1,4,5,51
Roses Bella Cucina,Douglas,3980 Limelight Ave Unit A,4,4,8,48
Rosies Diner,Arapahoe,14061 E Iliff Ave,6,6,12,44
Rositas Mexican Restaurant,Adams,8050 Federal Blvd,2,2,4,52
Roux World Kitchen,Douglas,556 Village Square Ln Unit 200,2,6,8,48
Roxborough Elementary,Douglas,8000 Village Cir W,3,2,5,51
Roxborough Intermediate School,Douglas,7370 Village Cir E,0,2,2,54
Roxborough Shell,Douglas,7887 N Rampart Range Rd,3,5,8,48
Royal Delights Chocolate Shop,Douglas,650 Perry Park Rd,0,0,0,56
Royal Gourmet,Arapahoe,15413 E Hampden Ave,5,4,9,47
Royal Hilltop,Arapahoe,18581 E Hampden Ave Unit 134,3,5,8,48
Rubios Coastal Grill,Arapahoe,111 W Mineral Ave,2,3,5,51
Rubios Fresh Mexican Grill 121,Douglas,3620 E Highlands Ranch Pkwy Unit 101,1,0,1,55
Rubios Mexican Grill,Arapahoe,16891 E Quincy Ave Unit C,8,10,18,38
Rudis Deli,Douglas,12501 E Lincoln Ave,3,4,7,49
Runyon Elementary,Arapahoe,7455 S Elati St,0,0,0,56
Rusty Bucket Restaurant and Tavern,Adams,14613 Orchard Pkwy Ste 100,2,3,5,51
Rusty Tapp Colorado BBQ and Catering,Arapahoe,311 E County Line Rd,2,0,2,54
SAAR Conoco,Arapahoe,1191 S Buckley Rd,1,1,2,54
SM Groceries,Arapahoe,12203 E Iliff Ave Ste W,5,4,9,47
SM Marts LLC,Arapahoe,250 E Dry Creek Rd Unit 201,3,2,5,51
STEM Launch,Adams,9450 Pecos St,0,1,1,55
STEM School and Academy,Douglas,8878 Barrons Blvd,1,0,1,55
Sable Elementary,Arapahoe,2601 Sable Blvd,0,2,2,54
Sabor Mexican Grill 2,Arapahoe,14301 E Cedar Ave Unit A,4,3,7,49
Sabor Mexican Grill 3,Arapahoe,5350 S Parker Rd,2,2,4,52
Sabor Mexican Grill Inc 1,Arapahoe,12201 E Arapahoe Rd Unit A6,3,5,8,48
Sabroso Fresh Mexican Grill,Arapahoe,8719 E Dry Creek Rd Unit C,3,2,5,51
Sachi Sushi,Adams,13801 Grant St Unit 570,5,2,7,49
Saddle Ranch Elementary,Douglas,805 English Sparrow Trl,0,0,0,56
Saddle Rock Grill,Arapahoe,21705 E Arapahoe Rd,5,2,7,49
Safeway Fuel Facility 2791,Arapahoe,181 W Mineral Ave,0,0,0,56
Safeway Fuel Kiosk 1873,Adams,9640 Washington St,4,2,6,50
Safeway Fuel Kiosk 2612,Arapahoe,1697 S Havana St,0,1,1,55
Safeway Store 0008,Arapahoe,7375 E Arapahoe Rd,0,1,1,55
Safeway Store 0017,Arapahoe,201 E Jefferson Ave,1,1,2,54
Safeway Store 008 - AFC Sushi,Arapahoe,7375 E Arapahoe Rd,0,0,0,56
Safeway Store 0137,Arapahoe,12200 E Mississippi Ave,1,3,4,52
Safeway Store 1446,Douglas,11051 S Parker Rd,3,6,9,47
Safeway Store 1446 - AFC Sushi,Douglas,11051 S Parker Rd,1,1,2,54
Safeway Store 1480,Douglas,9255 S Broadway,0,6,6,50
Safeway Store 1480 - AFC Sushi,Douglas,9255 S Broadway,1,0,1,55
Safeway Store 1548,Douglas,9229 E Lincoln Ave,2,7,9,47
Safeway Store 1548 - AFC Sushi,Douglas,9229 E Lincoln Ave,0,1,1,55
Safeway Store 1635,Adams,10300 Federal Blvd,2,5,7,49
Safeway Store 1873,Adams,771 Thornton Pkwy,3,5,8,48
Safeway Store 1873 - AFC Sushi,Adams,771 Thornton Pkwy,1,1,2,54
Safeway Store 1877,Douglas,880 S Perry St,1,1,2,54
Safeway Store 1877 - AFC Sushi,Douglas,880 S Perry St,0,0,0,56
Safeway Store 1928,Arapahoe,18730 E Hampden Ave,2,3,5,51
Safeway Store 2612,Arapahoe,1677 S Havana St,2,4,6,50
Safeway Store 2612 - AFC Sushi,Arapahoe,1677 S Havana St,0,0,0,56
Safeway Store 2722,Douglas,8355 N Rampart Range Rd,4,6,10,46
Safeway Store 2791 - AFC Sushi,Arapahoe,181 W Mineral Ave,0,0,0,56
Safeway Store 2917,Adams,1605 E Bridge St,1,5,6,50
Safeway Store 841,Arapahoe,1200 S Buckley Rd,3,2,5,51
Safeway Store 881,Adams,500 E 120th Ave,0,2,2,54
Safeway Store 892 - AFC Sushi,Adams,3840 E 104th Ave,0,1,1,55
Safeway Store 892 and Starbucks Coffee,Adams,3840 E 104th Ave,1,1,2,54
Safeway Store 899,Arapahoe,6100 S Gun Club Rd,0,1,1,55
Safeway Store 899 - AFC Sushi,Arapahoe,6100 S Gun Club Rd,0,0,0,56
Sage Canyon Elementary,Douglas,2420 Autumn Sage St,0,2,2,54
Sagebrush Elementary,Arapahoe,14700 E Temple Pl,0,0,0,56
Sagewood Middle School,Douglas,4725 Fox Sparrow Rd,0,1,1,55
Sahara Restaurant,Arapahoe,9636 E Arapahoe Rd,8,11,19,37
Saigon Basil,Adams,10665 Melody Dr,7,6,13,43
Saigon Bistro,Arapahoe,12303 E Mississippi Ave Ste 145,3,0,3,53
Saigon Bowl,Adams,9931 Grant St,7,6,13,43
Saigon Pho and Grill,Adams,7243 Federal Blvd Unit 100,5,7,12,44
Saigon Tokyo Asian Fusion Restaurant,Arapahoe,700 S Buckley Rd Unit E,6,2,8,48
Saint Marys School Littleton,Arapahoe,6853 S Prince St,0,2,2,54
Saint Thomas More School,Arapahoe,7071 E Otero Ave,3,1,4,52
Saj Mediterranean Grill,Arapahoe,2300 S Parker Rd Unit C,5,7,12,44
Sakana,Adams,7520 Sheridan Blvd,5,4,9,47
Sakura Bowl,Arapahoe,7555 E Arapahoe Rd Unit 5E,1,0,1,55
Sakura Hibachi & Sushi,Arapahoe,14045 E Evans Ave,3,4,7,49
Saltgrass Steak House,Adams,8931 Yates St,2,3,5,51
Saltgrass Steak House,Douglas,19310 Cottonwood Dr,4,5,9,47
Samarkand Restaurant,Arapahoe,1842 S Parker Rd Unit 2,10,4,14,42
Sams 3,Arapahoe,2580 S Havana St,7,7,14,42
Sams 3 Glendale,Arapahoe,435 S Cherry St,5,3,8,48
Sams Club #4853,Douglas,5940 Promenade Pkwy,2,2,4,52
Sams Club 4745,Adams,9601 Grant St,3,3,6,50
Sams Club 4816,Arapahoe,6201 S Aurora Pkwy,1,3,4,52
Sams Club 6631,Arapahoe,880 S Abilene St,4,2,6,50
Sams Club 6634,Douglas,7817 Park Meadows Dr,1,3,4,52
Sams Meat Market,Arapahoe,2300 S Chambers Rd,2,2,4,52
Sams Service Station,Adams,680 E 84th Ave,2,1,3,53
San Antonio Fresh Mexican Bakery and Juice Bar,Adams,9071 Washington St Unit G,1,1,2,54
San Salvador,Arapahoe,4385 S Federal Blvd,8,6,14,42
Sanctuary Inc,Douglas,7549 Daniels Park Rd,0,4,4,52
Sand Creek Elementary,Douglas,8898 Maplewood Dr,0,0,0,56
Sandburg School,Arapahoe,6900 S Elizabeth St,0,0,0,56
Sandcreek Lounge,Arapahoe,16893 E Iliff Ave,7,9,16,40
Santiagos,Adams,128 W Bridge St,2,4,6,50
Santiagos Mexican Restaurant,Adams,1150 E Bridge St,2,4,6,50
Santiagos Mexican Restaurant,Adams,1380 W 104th Ave,1,2,3,53
Santiagos Mexican Restaurant,Adams,15330 E 120th Pl,2,2,4,52
Santiagos Mexican Restaurant,Adams,180 W 84th Ave,4,1,5,51
Santiagos Mexican Restaurant,Adams,5230 E 72nd Ave,1,0,1,55
Santiagos Mexican Restaurant,Arapahoe,10400 E 6th Ave,1,6,7,49
Santiagos Mexican Restaurant,Arapahoe,4168 S Broadway,1,2,3,53
Santiagos Mexican Restaurant,Douglas,860 Kinner St,2,10,12,44
Santoros at the Ice Ranch,Arapahoe,841 Southpark Dr,3,7,10,46
Sapp Brothers Cafe,Adams,7120 E 49th Ave,4,8,12,44
Sarku Japan,Arapahoe,14200 E Alameda Ave Unit 2064A,2,3,5,51
Saturday Night Live,Adams,7950 Federal Blvd,0,2,2,54
Save A Lot,Adams,1000 W 104th Ave,5,1,6,50
Save A Lot,Adams,3045 W 74th Ave,6,10,16,40
Save A Lot,Adams,630 W 84th Ave,3,4,7,49
Save A Lot,Adams,7290 Monaco St,3,3,6,50
Save A Lot,Arapahoe,15220 E 6th Ave,7,6,13,43
Save A Lot Grocery Store 702,Arapahoe,698 Peoria St,3,3,6,50
Savory Spice Shop,Arapahoe,2650 W Main St,0,2,2,54
Savory Spice Shop,Arapahoe,6235 S Main St,0,0,0,56
Sawara,Douglas,312 Metzler Dr Unit D,4,6,10,46
Sazza,Arapahoe,2500 E Orchard Rd Unit E,4,6,10,46
Sbarro 939,Arapahoe,14200 E Alameda Ave,5,3,8,48
Schlotzskys,Arapahoe,9624 E Arapahoe Rd,10,5,15,41
Schwab Cafe,Douglas,10000 Bellwether Ln,0,4,4,52
Scileppis at the Old Stone Church,Douglas,210 Third St,5,6,11,45
Scooters,Arapahoe,13698 E Alameda Ave,4,6,10,46
Scooters Coffee,Adams,11461 Washington St,1,1,2,54
Scott Carpenter Middle School,Adams,7001 Lipan St,1,1,2,54
Sea Jong Kwan Korean BBQ,Arapahoe,2680 S Havana St Unit B,3,5,8,48
Seasons 52 4544,Douglas,8325 Park Meadows Center Dr,2,3,5,51
Second Creek Elementary,Adams,9950 Laredo Dr,0,1,1,55
Sedalia Elementary,Douglas,5449 N Huxtable St,0,3,3,53
Sees Candies Shop CO2,Arapahoe,7301 S Santa Fe Dr Unit 218,0,0,0,56
Senor Miguels Mexican Restaurant,Arapahoe,894 S Buckley Rd,4,1,5,51
Senor Rics,Arapahoe,13200 E Mississippi Ave,2,3,5,51
Seoul BBQ and Sushi,Arapahoe,2080 S Havana St,2,4,6,50
Seoul BBQ and Sushi Two,Adams,311 W 104th Ave,8,10,18,38
Seoul Catering and Coffee Shop,Arapahoe,2070 S Havana St,7,10,17,39
Serafinis Pizzeria,Adams,2414 E Bridge St Unit A,5,2,7,49
Sertinos Coffee,Arapahoe,15285 E Smoky Hill Rd,2,3,5,51
Seven Eleven,Adams,8378 Sheridan Blvd,4,4,8,48
Seven Eleven,Arapahoe,18351 E Colfax Ave,3,0,3,53
Seven Eleven,Arapahoe,3060 S Havana St,5,0,5,51
Seven Eleven,Douglas,3650 E Highlands Ranch Pkwy,2,1,3,53
Seven Eleven,Douglas,80 Plum Creek Pkwy,2,5,7,49
Seven Eleven 13157A,Adams,7270 Broadway,0,2,2,54
Seven Eleven 13167A,Adams,7540 Pecos St,1,2,3,53
Seven Eleven 13204C,Adams,10201 Montview Blvd,2,2,4,52
Seven Eleven 13206B,Arapahoe,3900 S Broadway,1,1,2,54
Seven Eleven 15403J,Adams,1600 W 92nd Ave,2,3,5,51
Seven Eleven 1610-39732,Arapahoe,13690 E Alameda Ave,2,3,5,51
Seven Eleven 1610-39733,Douglas,9010 Park Meadows Dr,0,6,6,50
Seven Eleven 1610-39752,Adams,2271 W 128th Ave,4,2,6,50
Seven Eleven 18556A,Adams,8801 Huron St,3,1,4,52
Seven Eleven 18576B,Adams,3901 E 112th Ave,4,0,4,52
Seven Eleven 20182A,Arapahoe,1499 W Littleton Blvd,0,1,1,55
Seven Eleven 21242A,Arapahoe,6515 S Dayton St,1,2,3,53
Seven Eleven 21494B,Arapahoe,3005 S Peoria St,2,3,5,51
Seven Eleven 22194A,Arapahoe,14490 E Colfax Ave,5,2,7,49
Seven Eleven 23418A,Arapahoe,10502 E Colfax Ave,1,4,5,51
Seven Eleven 24856A,Adams,1066 E 88th Ave,5,3,8,48
Seven Eleven 25325B,Adams,12057 Pecos St,3,2,5,51
Seven Eleven 2533C,Arapahoe,4601 S Broadway,7,4,11,45
Seven Eleven 25718B,Arapahoe,2220 S Peoria St,1,3,4,52
Seven Eleven 25823B,Adams,7201 Lowell Blvd,1,1,2,54
Seven Eleven 26289A,Adams,2500 E 88th Ave,6,5,11,45
Seven Eleven 26682A,Arapahoe,14593 E Mississippi Ave,2,3,5,51
Seven Eleven 27033A,Arapahoe,5595 S Broadway,3,1,4,52
Seven Eleven 27211A,Arapahoe,15511 E 6th Ave,9,11,20,36
Seven Eleven 27213B,Arapahoe,16601 E Smoky Hill Rd,2,6,8,48
Seven Eleven 29024A,Arapahoe,880 S Buckley Rd,2,2,4,52
Seven Eleven 29314A,Adams,10410 Melody Dr,2,4,6,50
Seven Eleven 33038C,Arapahoe,18451 E Alameda Pkwy,2,2,4,52
Seven Eleven 33598A,Arapahoe,3495 S Federal Blvd,6,2,8,48
Seven Eleven 34035A,Douglas,19832 Hilltop Rd,2,4,6,50
Seven Eleven 34057A,Douglas,11802 E Oswego St,1,7,8,48
Seven Eleven 34087A,Adams,15610 E 104th Ave,1,2,3,53
Seven Eleven 34504B,Arapahoe,7451 S Gartrell Rd,5,5,10,46
Seven Eleven 34726A,Arapahoe,2295 S Chambers Rd Ste O,2,2,4,52
Seven Eleven 35357J,Adams,5190 W 113th Ave,1,1,2,54
Seven Eleven 35622H,Arapahoe,6630 S Yosemite St,1,1,2,54
Seven Eleven 35715B,Adams,3876 E Bromley Ln,5,4,9,47
Seven Eleven 3582A,Adams,6966 Dahlia St,2,5,7,49
Seven Eleven 35864A,Adams,8991 E 104th Ave,5,2,7,49
Seven Eleven 36013A,Adams,12060 E 120th Ave,4,7,11,45
Seven Eleven 36017A,Adams,4900 E Bridge St,1,8,9,47
Seven Eleven 36775A,Adams,5797 Quebec St,5,6,11,45
Seven Eleven 37120A,Arapahoe,3200 Chambers Rd,3,4,7,49
Seven Eleven 37570A,Adams,8836 E 96th Ave,4,0,4,52
Seven Eleven 37731A,Adams,6400 Federal Blvd,0,2,2,54
Seven Eleven 37763A,Arapahoe,17050 E Smith Rd,6,6,12,44
Seven Eleven 38083A,Adams,7382 N Federal Blvd,2,1,3,53
Seven Eleven 38093A,Douglas,1175 Aloha St,1,0,1,55
Seven Eleven 38364A,Arapahoe,3800 Tower Rd,4,0,4,52
Seven Eleven 38390A,Arapahoe,599 S Airport Blvd,3,2,5,51
Seven Eleven 39034A,Arapahoe,4601 S Santa Fe Dr,3,3,6,50
Seven Eleven 39067,Douglas,12358 S Parker Rd,0,0,0,56
Seven Eleven 39211A,Douglas,810 Wilcox St,3,4,7,49
Seven Eleven 39296D,Adams,8820 Colorado Blvd,4,2,6,50
Seven Eleven 39317A,Douglas,3520 Town Center Dr,2,3,5,51
Seven Eleven 39421A,Douglas,9301 S Parker Rd,1,3,4,52
Seven Eleven 39768,Adams,12085 E Colfax Ave,4,2,6,50
Seven Eleven 39774A,Adams,9590 Federal Blvd,2,0,2,54
Seven Eleven 39834A,Douglas,7505 Parkway Dr,1,1,2,54
Seven Eleven 39847,Arapahoe,9171 E Arapahoe Rd,5,0,5,51
Seven Star Sushi,Adams,13123 E 16th Ave,0,0,0,56
Shack The,Arapahoe,151 W Mineral Ave Unit 101,6,9,15,41
Shadow Ridge Middle School,Adams,12551 Holly St,0,1,1,55
Shahristan Convenience Store,Adams,7310 Broadway,0,2,2,54
Shake Shack,Douglas,6370 Promenade Pkwy,0,1,1,55
Shalom Park Bistro,Arapahoe,14800 E Belleview Rd,3,1,4,52
Shalom Park Main Kitchen,Arapahoe,14800 E Belleview Dr,5,2,7,49
Shanghai 360,Douglas,8515 Park Meadows Center Dr Unit 3012,7,9,16,40
Shanghai Garden,Arapahoe,2500 E Arapahoe Rd,9,7,16,40
Shanghai Kitchen,Arapahoe,4940 S Yosemite St Unit E8,3,3,6,50
Shaw Heights Junior High School,Adams,8780 Circle Dr,0,0,0,56
Shawarma Grill,Arapahoe,7527 S University Blvd,4,3,7,49
Sheabeen Irish Pub,Arapahoe,2300 S Chambers Rd Unit A,5,3,8,48
Shebelle International Market,Arapahoe,10731 E Alameda Ave Unit D,3,6,9,47
Shell,Adams,6400 Sheridan Blvd,0,1,1,55
Shell,Adams,9001 I-76 Service Rd,5,2,7,49
Shell,Arapahoe,12098 E Mississippi Ave,2,3,5,51
Shell,Arapahoe,13780 E 6th Ave,5,5,10,46
Shell,Arapahoe,16890 E Iliff Ave,1,2,3,53
Shell,Arapahoe,3385 S Tower Rd,1,1,2,54
Shell,Arapahoe,6200 S Santa Fe Dr,2,2,4,52
Shell,Arapahoe,6515 S Broadway,1,1,2,54
Shell,Arapahoe,6556 S Broadway,1,0,1,55
Shell,Arapahoe,8020 S Broadway,0,1,1,55
Sheraton DTC,Arapahoe,7007 S Clinton St,5,9,14,42
Sheridan 3-8 School,Arapahoe,4000 S Lowell Blvd,0,1,1,55
Sheridan Cafe,Adams,5055 W 72nd Ave # 1,4,5,9,47
Sheridan Early Childhood Center,Arapahoe,4107 S Federal Blvd,2,0,2,54
Sheridan High School,Arapahoe,3201 W Oxford Ave,0,2,2,54
Sherrelwood Elementary,Adams,8095 Kalamath St,0,1,1,55
Shiloh House,Arapahoe,9700 E Easter Ln,2,4,6,50
Shop N Go,Arapahoe,3501 S Logan St,4,1,5,51
Shop and Save,Arapahoe,6802 S Yosemite St,4,5,9,47
Shotgun Willies,Arapahoe,490 S Colorado Blvd,3,2,5,51
Si Amigos,Arapahoe,9500 E Colfax Ave,6,4,10,46
Side Creek Elementary,Arapahoe,19191 E Iliff Ave,1,0,1,55
Siena at the Courtyard,Douglas,333 Perry St Unit D,8,11,19,37
Sierra Grill,Douglas,10680 Cabela Dr,1,3,4,52
Sierra Middle School,Douglas,6651 E Pine Ln,0,0,0,56
Silla Restaurant,Arapahoe,3005 S Peoria St Ste F,7,4,11,45
Silver Bullet Saloon,Adams,3734 E 120th Ave,1,2,3,53
Silver Creek Elementary,Adams,15101 Fillmore St,0,0,0,56
Silver Hills Middle School,Adams,12400 Huron St,0,2,2,54
Silver Spoons and Easy Entrees,Douglas,9064 Forsstrom Dr,0,0,0,56
Simple Simons Pizza,Arapahoe,1500 W Littleton Blvd Unit 126,1,0,1,55
Sir Chocolate,Arapahoe,6950 S Tucson Way Ste Q,1,2,3,53
Sixth Avenue Elementary,Arapahoe,560 Vaughn St,0,2,2,54
Skate City,Arapahoe,15100 E Girard Ave,2,2,4,52
Skippys Bar and Grill,Arapahoe,7545 E Iliff Ave,3,4,7,49
Sky Box Lounge,Arapahoe,7770 S Peoria St,6,1,7,49
Sky Ridge Medical Center,Douglas,10101 Ridgegate Pkwy,0,3,3,53
Sky Vista Middle School,Arapahoe,4500 S Himalaya St,0,0,0,56
Skyline Vista Elementary,Adams,7395 Zuni St,1,2,3,53
Skyview Academy - Kitchen,Douglas,6161 Business Center Dr,0,0,0,56
Skyview Elementary,Adams,5021 E 123rd Pl,0,0,0,56
Skyview Kitchen,Adams,8990 York St,2,3,5,51
Slatterys Irish Pub,Arapahoe,5364 Greenwood Plaza Blvd,4,5,9,47
Smack Daddys,Arapahoe,3960 S Federal Blvd,5,4,9,47
Small Cakes Cupcakery,Arapahoe,5616 S Gibraltar Way Unit H,2,1,3,53
Smart Cow Yogurt Bar,Douglas,36 E Allen St Ste C,1,2,3,53
SmashBurger 1026,Adams,832 E 120th Ave,2,3,5,51
SmashBurger 1032,Arapahoe,2630 S Parker Rd Ste B,0,2,2,54
SmashBurger 1268,Douglas,9563 S University Blvd Ste A,0,4,4,52
SmashBurger 1316,Arapahoe,13700 E Colfax Ave Unit 14,3,5,8,48
Smashburger,Adams,14375 Orchard Pkwy Ste 500,3,4,7,49
Smashburger,Adams,2690 W 104th Ave Unit 100,3,6,9,47
Smashburger,Arapahoe,1120 S Colorado Blvd,0,1,1,55
Smashburger,Arapahoe,2330 E Arapahoe Rd Ste 909,3,2,5,51
Smashburger,Arapahoe,23890 E Smoky Hill Rd Unit 40,2,7,9,47
Smashburger,Arapahoe,9696 E Arapahoe Rd,2,4,6,50
Smashburger,Douglas,4991 Factory Shops Blvd Unit A-150,0,0,0,56
Smokin Daves BBQ & Brew,Adams,1551 Cortez St,4,5,9,47
Smokin Daves BBQ and Brew,Arapahoe,7685 E Arapahoe Rd,4,4,8,48
Smokin Fins,Arapahoe,2575 W Main St,3,3,6,50
Smokin Fins,Douglas,1104 CPL Max Donahue Ln Unit 102,0,5,5,51
Smoky Hill High School,Arapahoe,16100 E Smoky Hill Rd,0,1,1,55
Smoothie King,Douglas,1100 Sgt Jon Stiles Dr Unit 101,1,0,1,55
Smoothie King SK1637,Adams,14452 Orchard Pkwy Ste 100,0,3,3,53
Snarfs,Adams,1975 W 120th Ave Unit 900,2,7,9,47
Sno Fox Sushi,Adams,15051 E 104th Ave,2,0,2,54
Snobahn,Arapahoe,6955 S York St Ste 404,2,0,2,54
Snooze,Douglas,10002 Common St Ste E1,1,5,6,50
Snooze AM Eatery,Arapahoe,6781 S York St Ste 515,1,2,3,53
Snooze An AM Eatery,Adams,14345 Orchard Pkwy,5,1,6,50
Snow Fox,Arapahoe,7901 S Broadway,0,0,0,56
Snow Fox KS-47,Arapahoe,7575 S University Blvd,0,0,0,56
Snow Fox Sushi KS 84 Sushi,Arapahoe,6412 S Parker Rd,0,0,0,56
Snow Fox Sushi at King Soopers 101,Adams,13700 Colorado Blvd,3,0,3,53
Snowfox KS 108,Douglas,4000 Red Cedar Dr,0,0,0,56
So Gong Dong Tofu Since 1962,Arapahoe,2353 S Havana St Unit D1,8,9,17,39
Soaring Hawk Elementary 37,Douglas,4665 Tanglevine Dr,0,0,0,56
Social Bar and Lounge,Arapahoe,3625 W Bowles Ave Unit 9,0,0,0,56
Sodexo America LLC at CH2M Hill,Douglas,9191 S Jamaica St,3,6,9,47
Sodexo at Liberty Media,Douglas,12300 Liberty Blvd,1,1,2,54
Sodexo at Nordstrom Englewood,Arapahoe,13531 E Caley Ave,0,0,0,56
Solera Salon,Arapahoe,8770 E Arapahoe Rd,2,2,4,52
Solid Grounds Coffee House,Arapahoe,6504 S Broadway,2,3,5,51
Solomons Grocery And European Deli,Arapahoe,1939 S Havana St,4,4,8,48
Sonic Drive In,Arapahoe,11237 E Arapahoe Pl,4,5,9,47
Sonic Drive In,Douglas,16538 Keystone Blvd,0,0,0,56
Sonic Drive In,Douglas,210 Founders Pkwy,2,2,4,52
Sonic Drive In 3558,Adams,9500 Federal Blvd,2,0,2,54
Sonic Drive In 3600,Adams,3605 E 104th Ave,3,2,5,51
Sonic Drive In 3657,Adams,950 E 120th Ave,1,3,4,52
Sonic Drive In 3797,Arapahoe,18535 E Smoky Hill Rd,1,3,4,52
Sonic Drive In 4168,Arapahoe,18501 E Hampden Ave,2,4,6,50
Sonic Drive In 4390,Arapahoe,7739 E Iliff Ave,4,4,8,48
Sonic Drive In 4426,Adams,15120 Brighton Rd,2,5,7,49
Sonic Drive In 4818,Arapahoe,1016 S Abilene St,3,2,5,51
Sonic Drive In 4980,Adams,8711 Washington St,3,2,5,51
Sonic Drive In 5366,Douglas,8367 N Rampart Range Rd,1,3,4,52
Sonic Drive In 5476,Arapahoe,11658 E Colfax Ave,4,4,8,48
Sonic Drive In 5541,Adams,10319 Tower Rd,4,2,6,50
Sonoda Japanese Restaurant,Arapahoe,3108 S Parker Rd Unit D1,5,5,10,46
Souper Deli,Arapahoe,9200 E Panorama Cir Ste H,5,4,9,47
Souper Deli The,Arapahoe,3190 S Vaughn Way Ste 110,1,1,2,54
South Denver Cardiology,Arapahoe,1000 Southpark Dr,3,4,7,49
South Elementary,Adams,305 S Fifth Ave,1,4,5,51
South Garden II,Douglas,4833 Front St Unit A,8,7,15,41
South Garden III,Douglas,12919 Stroh Ranch Ct Unit A,5,10,15,41
South Middle School,Arapahoe,12310 E Parkview Dr,0,1,1,55
South Philly Cheese Steaks,Adams,220 Pavilions Pl Unit A,3,3,6,50
South Philly Cheese Steaks,Adams,3967 E 120th Ave,3,2,5,51
South Philly Cheese Steaks,Arapahoe,1400 E Hampden Ave Unit 1,1,2,3,53
South Restaurant,Arapahoe,3535 S Huron St,6,4,10,46
South Ridge Elementary,Douglas,1100 South St,0,0,0,56
South Suburban Golf Course Restaurant,Arapahoe,7900 S Colorado Blvd,4,3,7,49
South Suburban Ice Arena,Arapahoe,6580 S Vine St,2,2,4,52
Southeast Elementary,Adams,1595 E Southern St,1,3,4,52
Spalding Rehab Hospital,Arapahoe,900 Potomac St,2,3,5,51
Spice 8 Asian Kitchen,Arapahoe,4510 S Reservoir Rd Unit D,6,1,7,49
Spice Kitchen,Douglas,19751 E Mainstreet Unit R1,2,8,10,46
Spicy 9 Thai,Arapahoe,1984 Nome St,6,6,12,44
Spicy Basil Asian Grill,Arapahoe,3299 S Broadway Unit C,4,3,7,49
Spicy Chili and Pho,Arapahoe,1722 S Chambers Rd,6,5,11,45
Spicy Radish The,Adams,800 E 73rd Ave Unit 20,0,1,1,55
Spill The Tea,Adams,1040 W 104th Ave,3,2,5,51
Sport Station Bar and Grill,Arapahoe,850 Dayton St,6,6,12,44
Sports Book Bar and Grill,Arapahoe,9660 E Arapahoe Rd,4,6,10,46
Sports Lounge Off Broadway The,Douglas,44 W Centennial Blvd,5,1,6,50
Sportsbook Bar and Grill - Simply Salads,Arapahoe,9660 E Arapahoe Rd,3,2,5,51
Sportswatch Bar and Grill,Adams,6801 Lowell Blvd,3,4,7,49
Springhill Suites,Arapahoe,7900 E Peakview Ave,1,0,1,55
Springhill Suites Denver Parker,Douglas,9355 Silverado Dr,0,0,0,56
Sprouts Famers Market 317,Arapahoe,8557 E Arapahoe Rd,2,1,3,53
Sprouts Farmers Market,Adams,5150 W 120th Ave,2,4,6,50
Sprouts Farmers Market,Arapahoe,1150 S Ironton St Unit 130,3,3,6,50
Sprouts Farmers Market,Arapahoe,20831 E Smoky Hill Rd,0,2,2,54
Sprouts Farmers Market,Arapahoe,5001 S Broadway,2,2,4,52
Sprouts Farmers Market,Douglas,10018 Commons St,3,5,8,48
Sprouts Farmers Market,Douglas,9751 S Parker Rd,2,0,2,54
Sprouts Farmers Market 318,Douglas,1980 E County Line Rd,3,2,5,51
Sprouts Farmers Market 321,Adams,1131 E 120th Ave,3,6,9,47
Sprouts Farmers Markets,Douglas,5650 Allen Way Ste 106,1,5,6,50
Sprucewood Inn,Douglas,491 S Highway 67,4,1,5,51
Spur of The Moment,Douglas,8885 Spruce Mountain Rd,3,5,8,48
Squirrel Creek Lodge,Douglas,8109 Blakeland Dr,2,0,2,54
St Anthony North Health Campus,Adams,14300 Orchard Pkwy,1,4,5,51
St Anthonys Hospital North,Adams,2551 W 84th Ave,3,1,4,52
St Augustine Catholic Church and Community Food,Adams,178 S 6th Ave,0,2,2,54
St Joseph Ministry Center,Arapahoe,18000 E Arapahoe Rd,0,0,0,56
St Pius Tenth Parish,Arapahoe,13670 E 13th Pl,1,1,2,54
St Therese School,Arapahoe,1200 Kenton St,4,2,6,50
Stagecoach The,Douglas,2077 S Highway 83,1,11,12,44
Stampede,Arapahoe,2430 S Havana St,3,8,11,45
Stanley Beer Hall,Arapahoe,2501 S Dallas St Ste 100,7,6,13,43
Star of India,Arapahoe,3102 S Parker Rd Unit A10,4,3,7,49
Starbucks,Arapahoe,1510 W Littleton Blvd,2,0,2,54
Starbucks,Douglas,6375 Promenade Pkwy Ste 100,0,0,0,56
Starbucks,Douglas,910 Kinner St,0,0,0,56
Starbucks 13233,Adams,14456 Delaware St,3,4,7,49
Starbucks 13339,Douglas,9700 S Parker Rd Ste 100,1,5,6,50
Starbucks 254,Arapahoe,8243 S Quebec St,1,0,1,55
Starbucks 59397,Douglas,12227 Pine Bluffs Way Unit 101,0,1,1,55
Starbucks Coffee,Adams,10339 Tower Rd,0,1,1,55
Starbucks Coffee,Adams,10701 Washington St,1,2,3,53
Starbucks Coffee,Adams,5043 E Bridge St,0,1,1,55
Starbucks Coffee,Adams,550 W 104th,0,1,1,55
Starbucks Coffee,Adams,7358 Federal Blvd,0,2,2,54
Starbucks Coffee,Arapahoe,11703 E Arapahoe Rd,1,3,4,52
Starbucks Coffee,Arapahoe,12700 E Colfax Ave,1,2,3,53
Starbucks Coffee,Arapahoe,13702 E Quincy Ave,0,3,3,53
Starbucks Coffee,Arapahoe,13881 E Mississippi Ave,0,2,2,54
Starbucks Coffee,Arapahoe,410 S Colorado Blvd,1,1,2,54
Starbucks Coffee,Douglas,9854 Zenith Meridian Dr Ste C,0,0,0,56
Starbucks Coffee 10114,Arapahoe,3128 S Parker Rd,1,2,3,53
Starbucks Coffee 10438,Arapahoe,3455 Salida St Unit A,2,3,5,51
Starbucks Coffee 10632,Arapahoe,7500 S Gartrell Rd,0,1,1,55
Starbucks Coffee 10856,Arapahoe,1240 S Buckley Rd,0,1,1,55
Starbucks Coffee 11246,Arapahoe,10761 E Alameda Ave Unit A,1,0,1,55
Starbucks Coffee 11476,Arapahoe,4298 S Broadway,2,4,6,50
Starbucks Coffee 11479,Adams,13671 Colorado Blvd,1,1,2,54
Starbucks Coffee 11995,Douglas,9135 Commerce Center Cir,1,3,4,52
Starbucks Coffee 13490,Arapahoe,2600 W Belleview Ave Ste 100,1,1,2,54
Starbucks Coffee 17748,Arapahoe,9301 E Arapahoe Rd,0,1,1,55
Starbucks Coffee 19695,Arapahoe,3500 River Point Pkwy Unit A,1,1,2,54
Starbucks Coffee 2204,Arapahoe,7521 S University Blvd,0,1,1,55
Starbucks Coffee 239,Arapahoe,5910 S University Blvd Unit D3,1,0,1,55
Starbucks Coffee 249,Arapahoe,8547 E Arapahoe Rd Unit 1,1,0,1,55
Starbucks Coffee 252,Arapahoe,4920 S Yosemite St Unit,0,0,0,56
Starbucks Coffee 277,Arapahoe,960 S Colorado Blvd,0,0,0,56
Starbucks Coffee 5283,Arapahoe,19751 E Smoky Hill Rd Unit A,1,1,2,54
Starbucks Coffee 5299,Douglas,8505 Park Meadows Center Dr Ste 2084,3,3,6,50
Starbucks Coffee 5315,Douglas,8374 Willow St,3,1,4,52
Starbucks Coffee 5325,Douglas,870 Cpl Max Donahue Ln,0,0,0,56
Starbucks Coffee 5358,Adams,5180 W 120th Ave,0,1,1,55
Starbucks Coffee 54555,Adams,11995 N Holly St,0,1,1,55
Starbucks Coffee 5573,Arapahoe,15795 E Arapahoe Rd Ste 300,1,0,1,55
Starbucks Coffee 5647,Adams,1171 W 120th Ave Ste B,0,1,1,55
Starbucks Coffee 56826,Adams,12311 E 104th Ave,2,2,4,52
Starbucks Coffee 5722,Arapahoe,8000 E Belleview Ave Unit B10,0,0,0,56
Starbucks Coffee 5806,Adams,10339 N Federal Blvd,2,4,6,50
Starbucks Coffee 6569,Arapahoe,7301 S Santa Fe Dr Unit 310,0,0,0,56
Starbucks Coffee 6776,Arapahoe,8745 E Orchard Rd Ste 51,1,0,1,55
Starbucks Coffee 6821,Arapahoe,14261 E Cedar Ave Unit D,0,1,1,55
Starbucks Coffee 6833,Arapahoe,17200 E Iliff Ave Unit A1,0,0,0,56
Starbucks Coffee 6945,Adams,3894 E 120th Ave Unit B,1,1,2,54
Starbucks Coffee 8982,Douglas,506 E Castle Pines Pkwy,0,4,4,52
Starbucks Coffee 9554,Adams,45 E 120th Ave,1,4,5,51
Starbucks Coffee 9946,Adams,16769 Washington St,2,3,5,51
Starbucks Coffee Company,Douglas,9328 Jordan Rd Unit 101,1,2,3,53
Stargate Academy Secondary School,Adams,14530 Washington St,1,0,1,55
Starz Cafe,Douglas,8900 Liberty Cir,1,1,2,54
State House,Adams,15591 E 104th Ave,2,3,5,51
Staybridge Suites,Arapahoe,7150 S Clinton St,4,5,9,47
Staybridge Suites,Douglas,7820 Park Meadows Dr,2,1,3,53
Staybridge Suites Denver Cherry Creek,Arapahoe,4220 E Virginia Ave,2,5,7,49
Steak Escape Taco Johns,Adams,5810 Logan St,4,6,10,46
Steak N Shake 717,Arapahoe,3502 River Point Pkwy,2,7,9,47
Steakhouse 10,Arapahoe,3517 S Elati St,8,7,15,41
Steel Tips,Arapahoe,15162 E Hampden Ave Unit C,3,2,5,51
Stellar Elementary,Adams,3901 E 124th Ave,1,0,1,55
Stem Magnet School,Adams,11700 Irma Dr,0,0,0,56
Stem School and Academy,Douglas,8773 Ridgeline Blvd,0,0,0,56
Stephanies Coffee Shop,Adams,7691 Brighton Blvd,6,5,11,45
Stevos Pizza,Arapahoe,800 S Havana St,5,4,9,47
Stinker 329,Adams,3905 E 120th Ave,3,5,8,48
Stinker 331,Arapahoe,7500 S Broadway,1,1,2,54
Stinker 333,Arapahoe,13700 E Quincy Ave,2,0,2,54
Stinker 334,Arapahoe,15291 E Colfax Ave,4,1,5,51
Stinker 340,Arapahoe,800 W Hampden Ave,4,3,7,49
Stir Fry 88,Adams,13801 Grant St,7,7,14,42
Stone Canyon Edventures - DC Life Camp,Douglas,12163 S Perry Park Rd,4,5,9,47
Stone Creek Cafe 1,Arapahoe,5075 S Federal Blvd,6,2,8,48
Stone Mountain Elementary,Douglas,10625 Weathersfield Way,0,0,0,56
Stonebrook Manor,Adams,650 E 124th Ave,2,0,2,54
Stonegate Cafe,Douglas,16524 Keystone Blvd Unit F,1,4,5,51
Stout Street Foundation,Adams,7251 E 49th Ave,1,2,3,53
Strasburg Elementary School,Adams,56729 Colorado Ave,1,5,6,50
Strawberries Catering Taste of a lifetime,Arapahoe,3535 S Platte River Dr Unit A3,4,5,9,47
Stuart Middle School,Adams,15955 E 101st Way,0,0,0,56
Studio Cafe The,Adams,5445 Bannock St,2,0,2,54
Studio School The,Adams,10604 Grant Dr,0,0,0,56
Studio at Mainstreet,Douglas,19604 E Mainstreet,0,0,0,56
Stukey Elementary,Adams,11080 Grant Dr,1,1,2,54
Stumpys Pizza Bar and Grill,Douglas,138 S Wilcox St,6,11,17,39
Styria Bakery II,Adams,5650 Washington St,2,4,6,50
Submission Nutrition,Adams,12189 Pennsylvania St,0,0,0,56
Subway,Adams,10401 Belle Creek Pkwy Unit F,4,2,6,50
Subway,Adams,12501 E 17th Ave Unit D,6,2,8,48
Subway,Adams,5790 Clarkson St,5,2,7,49
Subway,Arapahoe,12073 E Arapahoe Rd Unit 120,1,0,1,55
Subway,Arapahoe,13692 E Iliff Ave Unit D,4,5,9,47
Subway,Arapahoe,19330 E Quincy Ave Unit A,3,2,5,51
Subway,Arapahoe,2648 S Parker Rd,2,1,3,53
Subway,Arapahoe,7410 S University Blvd,3,1,4,52
Subway,Douglas,11101 S Parker Rd,1,4,5,51
Subway,Douglas,13097 S Parker Rd Unit B,3,3,6,50
Subway,Douglas,848 N Ridge Rd Unit A,4,4,8,48
Subway - Arapahoe 7233,Arapahoe,8575 E Arapahoe Rd Unit L,3,3,6,50
Subway - Belleview 10349,Arapahoe,4940 S Yosemite St Unit E3,3,1,4,52
Subway - Broadway H R 19123,Douglas,9245 S Broadway Unit 200,0,1,1,55
Subway - Castle Pines 23742,Douglas,558 Castle Pines Pkwy Unit B5,3,6,9,47
Subway - Castle Rock 36685,Douglas,4400 Front St,2,5,7,49
Subway - Town center 23045,Douglas,3506 Town Ctr,2,2,4,52
Subway - Wildcat 23292,Douglas,2229 W Wildcat Reserve Pkwy,5,2,7,49
Subway 03271 - Federal,Adams,7312 Federal Blvd,1,1,2,54
Subway 11103,Douglas,9227 E Lincoln Ave Ste 600,1,0,1,55
Subway 12979,Arapahoe,15340 E Alameda Pkwy,2,2,4,52
Subway 14131,Adams,5076 W 92nd Ave Unit D3,5,1,6,50
Subway 14270,Adams,7260 Broadway,1,3,4,52
Subway 24225,Adams,10376 Colorado Blvd,2,5,7,49
Subway 2701,Arapahoe,123 W Hampden Ave Unit E,4,2,6,50
Subway 3566,Arapahoe,7941 S Broadway,4,1,5,51
Subway 3705,Adams,10390 Washington St,8,2,10,46
Subway 37800,Adams,3301 N Tower Rd,2,3,5,51
Subway 38847,Adams,13644 Orchard Pkwy Unit 100,3,2,5,51
Subway 44052,Adams,56171 E Colfax Ave Unit 10,1,4,5,51
Subway 44404,Arapahoe,3602 River Point Pkwy Unit A,2,1,3,53
Subway 45773,Arapahoe,8450 E Iliff Ave Unit 1,2,2,4,52
Subway 56024,Adams,9213 Huron St,1,1,2,54
Subway 63602,Arapahoe,25791 E Smoky Hill Rd,3,0,3,53
Subway 64713,Arapahoe,4760 W Mineral Ave Ste 20,3,1,4,52
Subway Sandwiches,Adams,10343 Federal Blvd Unit A,2,5,7,49
Subway Sandwiches,Adams,8501 Grant St,3,3,6,50
Subway Sandwiches,Adams,858 E 120th Ave,3,3,6,50
Subway Sandwiches,Arapahoe,19761 E Smoky Hill Rd Unit B,4,2,6,50
Subway Sandwiches,Douglas,3996 Red Cedar Dr Unit A2,2,6,8,48
Subway Sandwiches & Salads,Arapahoe,10900 E Briarwood Ave,4,4,8,48
Subway Sandwiches & Salads,Arapahoe,4343 S Buckley Rd Ste 150,3,2,5,51
Subway Sandwiches 22093,Adams,450 E Bromley Ln Unit 120,2,1,3,53
Subway Sandwiches 36210,Adams,60 W Bromley Ln,4,1,5,51
Subway Sandwiches 37717,Douglas,6654 Timberline Rd Unit A,3,4,7,49
Subway Sandwiches 39977,Adams,7101 E 128th Ave,4,5,9,47
Subway Sandwiches 40865,Adams,18220 E 104th Ave Unit 103,2,2,4,52
Subway Sandwiches 41483,Adams,2315 Prairie Center Pkwy Unit E7,2,3,5,51
Subway Sandwiches 41703,Douglas,12155 Lioness Way # 101,6,2,8,48
Subway Sandwiches 4568,Adams,1509 W 84th Ave,3,2,5,51
Subway Sandwiches 46433,Arapahoe,320 S Colorado Blvd,2,0,2,54
Subway Sandwiches 52032,Arapahoe,2203 S Peoria St,2,2,4,52
Subway Sandwiches 695,Arapahoe,2897 W Belleview Ave Unit B,3,2,5,51
Subway Sandwiches and Salads,Adams,1005 W 120th Ave Ste 400,2,4,6,50
Subway Sandwiches and Salads,Adams,12910 Zuni St,4,3,7,49
Subway Sandwiches and Salads,Adams,965 S 1st St Unit C,1,2,3,53
Subway Sandwiches and Salads,Arapahoe,1250 S Buckley Rd Unit E,3,2,5,51
Subway Sandwiches and Salads,Arapahoe,14004 E Mississippi Ave,3,1,4,52
Subway Sandwiches and Salads,Arapahoe,1412 S Parker Rd Unit A126,7,1,8,48
Subway Sandwiches and Salads,Arapahoe,1470 Chambers Rd,0,0,0,56
Subway Sandwiches and Salads,Arapahoe,16950 E Iliff Ave Unit A,4,3,7,49
Subway Sandwiches and Salads,Arapahoe,40 W Littleton Blvd Unit 211,1,2,3,53
Subway Sandwiches and Salads,Arapahoe,4696 S Broadway,3,1,4,52
Subway Sandwiches and Salads,Douglas,17001 Lincoln Ave Unit B,2,6,8,48
Subway Sandwiches and Salads,Douglas,8820 American Way,1,0,1,55
Subway Sandwiches and Salads 14459,Adams,6075 E Parkway Dr Ste 103,1,3,4,52
Subway Sandwiches and Salads 2929,Arapahoe,1155 S Havana St Unit 67,3,2,5,51
Subway Sandwiches and Salads 5734,Adams,1543 E Bridge St,1,4,5,51
Subway Sandwiches and Salads Main 5428,Douglas,11017 S Parker Rd,3,5,8,48
Subway Sandwiches and Salads Quebec,Arapahoe,8223 S Quebec St Unit E,2,2,4,52
Subway Wilcox 7840,Douglas,110 S Wilcox St,5,4,9,47
Sudanese and Ethiopian Cafe and Bakery LLC,Arapahoe,10375 E Iliff Ave,4,3,7,49
Sugami Hibachi Express,Arapahoe,15434 E Mississippi Ave,3,2,5,51
Sugar Sisters Bakery,Douglas,34 E Allen St,2,2,4,52
Sugarfire Smokehouse,Adams,14375 Orchard Pkwy,7,5,12,44
Sukiya Ramen,Arapahoe,7939 E Arapahoe Rd Unit 110,2,1,3,53
Summit Elementary,Arapahoe,18201 E Quincy Ave,1,0,1,55
Summit Entertainment of Thornton,Adams,580 E 144th Ave,5,4,9,47
Summit View Elementary,Douglas,10200 S Piedmont Dr,0,2,2,54
Sun Cafe,Arapahoe,10 Inverness Dr E Unit 10,5,8,13,43
Sun Rise Restaurant,Adams,9115 E Colfax Ave,7,5,12,44
Sunburst Grill,Arapahoe,2295 S Chambers Rd Unit M,7,5,12,44
Sunflower Asian Cafe and Yang Zhou Kitchen,Arapahoe,91 W Mineral Ave Unit 100,11,9,20,36
Sunlite Donuts,Arapahoe,2186 W Evans Ave,1,4,5,51
Sunrise Asian Cuisine and Sushi Bar,Arapahoe,7450 S Gartrell Rd Unit A2-A4,5,5,10,46
Sunrise Elementary,Arapahoe,4050 S Genoa Way,0,1,1,55
Sunrise Sushi Cuisine,Adams,245 Pavilions Pl Unit F,5,7,12,44
Sunset Grille,Arapahoe,8269 S Holly St,2,2,4,52
Sunset Ridge Elementary/ SAT,Adams,9451 Hooker St,1,0,1,55
Sunshine Gas Station,Arapahoe,3298 S Broadway,2,0,2,54
Super 8 Westminster,Adams,12055 Melody Dr,1,0,1,55
Super Qwik Stop,Adams,1580 W 84th Ave,2,7,9,47
Super Target 1372,Adams,1001 E 120th Ave,2,3,5,51
Super Target T 2023,Douglas,10001 Commons St,3,3,6,50
Sure Stay Plus Hotel by Best Western,Adams,12101 Grant St,0,1,1,55
Surena Restaurant,Arapahoe,9625 E Arapahoe Rd,6,4,10,46
Sushi Basho,Arapahoe,2700 W Bowles Ave Unit A,8,8,16,40
Sushi Bay,Arapahoe,9623 E County Line Rd Unit C,7,0,7,49
Sushi Castle,Douglas,729 Barranca Dr Unit 105,8,13,21,35
Sushi Kai,Arapahoe,682 S Colorado Blvd,6,3,9,47
Sushi Katsu,Arapahoe,2222 S Havana St Unit H,3,8,11,45
Sushi Katsu 2,Arapahoe,9555 E Arapahoe Rd Unit 5,2,7,9,47
Sushi Kazu Japanese Restaurant,Arapahoe,12201 E Arapahoe Rd Unit B14,6,7,13,43
Sushi Man,Arapahoe,6920 S Jordan Rd Ste A,0,0,0,56
Sushi Mango,Douglas,9579 S University Blvd # 150,8,10,18,38
Sushi North,Adams,12010 Melody Dr,5,6,11,45
Sushi Rama,Arapahoe,13650 E Colfax Ave Unit E,2,3,5,51
Sushi Rama,Douglas,10012 Commons St Ste 106 E,2,3,5,51
Sushi Star,Adams,4880 W 120th Ave Ste 200,5,4,9,47
Sushi Tokoro,Adams,3925 E 120th Ave Unit A,6,4,10,46
Sushi Umi,Adams,10048 Grant St,5,4,9,47
Sushi Yume,Adams,10350 Federal Blvd Unit 400,7,9,16,40
Swedish Medical Center,Arapahoe,501 E Hampden Ave,0,2,2,54
Sweet Cow,Arapahoe,2501 Dallas St,3,0,3,53
Sweet Logic,Adams,12189 Pennsylvania St,1,0,1,55
Sweet Tomatoes,Douglas,9445 Park Meadows Dr,4,4,8,48
Sweet Tomatoes 69,Adams,8971 Yates St,0,3,3,53
Sweet Tomatoes Restaurant,Arapahoe,14015 E Evans Ave,3,3,6,50
Sweets of Inspiration,Adams,7305 Lowell Blvd Ste 180,2,3,5,51
Swingers Sports Lounge and Grill,Douglas,9535 Park Meadows Dr,6,12,18,38
Swirls Frozen Yogurt - COO,Douglas,19751 E Mainstreet Unit R4,1,1,2,54
T Square C Store,Arapahoe,897 S Havana St,1,2,3,53
TCBY Mrs Fields,Adams,2831 W 120th Ave Unit 100,1,4,5,51
TGI Fridays,Adams,1251 E 120th Ave,3,9,12,44
TNT Sports Lounge,Adams,5127 W 64th Ave,5,8,13,43
TREA Chapter 39,Arapahoe,15821 E Centretech Cir,2,1,3,53
TSE Jennys Market Phillips 66 530,Arapahoe,3500 S Federal Blvd,4,2,6,50
Taco Bell,Adams,10402 Belle Creek Blvd,1,2,3,53
Taco Bell,Arapahoe,21865 E Quincy Ave,2,1,3,53
Taco Bell,Arapahoe,25531 E Smoky Hill Rd,1,2,3,53
Taco Bell,Arapahoe,5050 S Quebec St,1,3,4,52
Taco Bell 20924,Adams,6390 Sheridan Blvd,0,3,3,53
Taco Bell 23306,Adams,13732 Colorado Blvd,2,1,3,53
Taco Bell 23963,Arapahoe,14551 E Colfax Ave,1,3,4,52
Taco Bell 2643,Douglas,10832 Crossroads Dr,2,1,3,53
Taco Bell 3186,Arapahoe,8220 S Quebec St,1,4,5,51
Taco Bell 33836,Adams,7221 Pecos St,2,3,5,51
Taco Bell 33838,Adams,555 W 104th Ave,2,3,5,51
Taco Bell 33842,Adams,920 E Bridge St,1,4,5,51
Taco Bell 33846,Adams,3901 E 120th Ave,0,1,1,55
Taco Bell 33850,Arapahoe,8695 E Arapahoe Rd,1,1,2,54
Taco Bell 33853,Arapahoe,1607 S Havana St,1,5,6,50
Taco Bell 33856,Adams,4901 E 60th Ave,0,1,1,55
Taco Bell 33857,Arapahoe,540 W Hampden Ave,3,0,3,53
Taco Bell 33865,Adams,1298 E 104th Ave,2,5,7,49
Taco Bell 33870,Adams,8401 Washington St,1,1,2,54
Taco Bell 33873,Arapahoe,2717 W Belleview Ave,3,5,8,48
Taco Bell 33874,Adams,2121 Prairie Center Pkwy,2,3,5,51
Taco Bell 36110,Douglas,217 Metzler Dr,1,2,3,53
Taco Bell 36111,Douglas,95 Rio Grande Dr,1,2,3,53
Taco Bell 36112,Douglas,7530 Village Square Dr,0,1,1,55
Taco Bell 36117,Arapahoe,14200 E Alameda Ave Unit 2070B,1,1,2,54
Taco Bell 4078,Arapahoe,7911 S Broadway,1,3,4,52
Taco Bell Express 20537,Arapahoe,6350 S Parker Rd,0,1,1,55
Taco Bell KFC 21392,Douglas,16950 Lincoln Ave,3,6,9,47
Taco Bell Long John Silvers,Douglas,3984 Red Cedar Dr,2,6,8,48
Taco House 5 LLP,Arapahoe,1390 W Littleton Blvd,1,0,1,55
Taco Jalpa,Adams,11417 E Colfax Ave,9,8,17,39
Taco Jalpa II,Adams,7710 Brighton Rd,4,2,6,50
Taco Johns,Adams,280 W 136th Ave,5,5,10,46
Taco Johns 9945,Adams,9675 Washington St,2,5,7,49
Taco Mex,Adams,1806 W 92nd Ave,6,8,14,42
Taco Mex IV,Adams,10909 E Colfax Ave,10,5,15,41
Taco Mex V,Adams,6101 E 64th Ave,4,0,4,52
Taco Mex VI,Arapahoe,2210 S Chambers Rd,5,3,8,48
Taco Orientales Chihuahua,Adams,105 E Bridge St Unit C,3,9,12,44
Taco Palace Mexican Fast Food,Adams,2020 E Bridge St,5,6,11,45
Taco River,Adams,7195 Federal Blvd,8,9,17,39
Taco River,Adams,75 S Main St,7,6,13,43
Taco River III,Adams,6025 E Parkway Dr Ste 107,2,2,4,52
Taco River IV,Adams,1685 Peoria St,7,8,15,41
Taco Star,Adams,1050 W 104th Ave,5,2,7,49
Taco Star,Adams,503 E 84th Ave,3,4,7,49
Taco Star,Arapahoe,1760 S Havana St,4,3,7,49
Taco y Salsa,Arapahoe,2284 S Chambers Rd,9,10,19,37
Tacos Chihuas,Adams,248 N Main St,4,6,10,46
Tacos D F,Arapahoe,2020 S Parker Rd Unit N,9,10,19,37
Tacos El Metate,Arapahoe,1742 S Chambers Rd,6,6,12,44
Tacos Junior Inc,Adams,11505 E Colfax Ave Unit D,9,8,17,39
Tacos Junior Inc,Adams,9277 Federal Blvd,3,3,6,50
Tacos La Morenita,Arapahoe,15493 E Hampden Ave Unit D,0,0,0,56
Tacos Los Vaqueros,Adams,1880 W 92nd Ave,6,3,9,47
Tacos Menny,Adams,283 E 88th Ave,5,13,18,38
Tacos Rapidos,Adams,612 E Bridge St,4,10,14,42
Tacos Sabor Chilango,Adams,6451 E 72nd Pl,5,6,11,45
Tacos Tijuana,Arapahoe,1430 Chambers Rd,9,11,20,36
Tacos Uruapan,Arapahoe,1465 N Dayton St,5,1,6,50
Tacos Y Salsa,Adams,7124 Federal Blvd Unit 700,9,14,23,33
Tacos y Salsa,Arapahoe,9103 E Colfax Ave,9,11,20,36
Tacos y Tortas Selene,Arapahoe,15343 E 6th Ave Unit A,4,4,8,48
Taft House,Douglas,3570 Celestial Ave,0,0,0,56
Tailgate Tavern,Douglas,19552 E Mainstreet,4,7,11,45
Takeria Takero-Mucho 2,Arapahoe,12028 E Mississippi Unit C,5,5,10,46
Takoda Tavern Kitchen and Bar,Douglas,12365 Pine Bluffs Way,4,3,7,49
Tamale Kitchen,Adams,1030 W 104th Ave,2,9,11,45
Tamale Kitchen 2,Adams,5650 Washington St,4,5,9,47
Tamale Kitchen 8,Douglas,6642 Timberline Rd Unit 105,1,5,6,50
Tamales Moreno,Adams,5159 W 64th Ave,2,4,6,50
Tamales by Sara,Adams,6440 E 72nd Pl,3,4,7,49
Tamarind Indian Cuisine,Douglas,514 Perry St,9,6,15,41
Tandoori Flames,Douglas,556 Village Square Ln Ste 200,3,4,7,49
Taqueria Corona II,Arapahoe,2222 S Havana St Unit I,2,3,5,51
Taqueria El Ayudante,Adams,8623 Washington St,3,2,5,51
Taqueria El Trompito,Adams,1540 W 70th Ave,3,8,11,45
Taqueria El Tucan,Adams,1550 W 88th Ave Unit F,8,3,11,45
Taqueria Jalisco Mexican Grill,Arapahoe,18581 E Hampden Ave Unit 132,2,0,2,54
Taqueria La Torteria,Adams,9165 Lowell Blvd,4,6,10,46
Taqueria Las Palmas 2,Adams,4955 W 72nd Ave Unit A,3,5,8,48
Taqueria Los Gallitos,Adams,7101 Pecos St,2,6,8,48
Taqueria Los Gallitos,Adams,7255 E 72nd Ave,5,7,12,44
Taqueria Los Gordos,Arapahoe,1034 S Sable Blvd,5,6,11,45
Taqueria Spicy Tacos,Adams,965 Platte River Blvd,8,7,15,41
Taqueria Y Carniceria Mi Lindo Michoacan,Adams,2001 Coronado Pkwy N,5,2,7,49
Tara Marts Inc,Adams,14081 E Colfax Ave,3,5,8,48
Target 1976,Arapahoe,7400 S Gartrell Rd,1,0,1,55
Target 2458,Arapahoe,15700 E Briarwood Cir,3,1,4,52
Target Store T 0256,Arapahoe,16910 E Quincy Ave,2,2,4,52
Target Store T 147,Arapahoe,6767 S Clinton St,2,3,5,51
Target Store T 2219,Douglas,11150 S Twenty Mile Rd,1,4,5,51
Target Store T 2261,Arapahoe,3650 River Point Pkwy,0,2,2,54
Target Store T 271,Douglas,1950 E County Line Rd,2,2,4,52
Target Store T2183 and Starbucks and Pizza Hut,Adams,2171 Prairie Center Pkwy,0,2,2,54
Target Store T2197,Adams,14451 Orchard Pkwy,3,4,7,49
Target Store T2716,Douglas,1265 Sgt Jon Stiles Dr,1,3,4,52
Target T 1326,Douglas,5010 Founders Pkwy,3,4,7,49
Target T 1806,Arapahoe,4301 E Virginia Ave,3,2,5,51
Taste of Philly,Adams,823 Thornton Pkwy,3,7,10,46
Taste of Philly,Arapahoe,18121 E Hampden Ave Unit B,2,3,5,51
Taste of Philly,Douglas,18901 E Mainstreet,4,6,10,46
Taste of Philly,Douglas,2660 E County Line Rd Unit B,7,2,9,47
Tasty Donuts,Adams,6441 E 72nd Pl,0,0,0,56
Tasty Garden,Adams,420 E 120th Ave Unit B5,4,6,10,46
Tasty House,Douglas,804 N Ridge Rd Ste B,9,11,20,36
Tatas Burritos 2,Arapahoe,5677 S Himalaya Way,1,8,9,47
Tavern Littleton,Arapahoe,2589 W Main St,2,5,7,49
Tavern Tech Center,Arapahoe,5336 DTC Blvd,4,2,6,50
Tay Do Asian Grocery,Adams,7404 Irving St,0,6,6,50
Taz Indian Restaurant,Arapahoe,10731 E Alameda Ave,5,9,14,42
Tazikis Mediterranean Cafe,Adams,100 E 120th Ave Unit C110,5,3,8,48
Tea Street,Arapahoe,4090 E Mississippi Ave,1,0,1,55
Tea4U,Arapahoe,3602 River Point Pkwy Unit C,1,2,3,53
Teds Montana Grill,Adams,11970 Bradburn Blvd,4,11,15,41
Teds Montana Grill,Adams,16495 E 40th Cir,2,5,7,49
Teds Montana Grill,Arapahoe,5370 Greenwood Plaza Blvd Unit 10,6,4,10,46
Teds Montana Grill,Arapahoe,7301 S Santa Fe Dr,5,9,14,42
Teds Montana Grill 47,Arapahoe,6105 S Main St,7,4,11,45
Teds Phily Chease Steak,Adams,7215 E 72nd Ave Unit A,3,0,3,53
Tedz Place,Adams,5271 E 52nd Ave,4,1,5,51
Tejal India Grocery,Adams,10351 Grant St Unit 6,0,3,3,53
Ten Second LLC,Arapahoe,2000 S Havana St,4,2,6,50
Tennyson Knolls Elementary,Adams,6330 Tennyson St,0,1,1,55
Tequilas Family Mexican Restaurant,Adams,12020 Pennsylvania St,6,3,9,47
Teriyaki Madness,Arapahoe,8547 E Arapahoe Rd Unit F,4,2,6,50
Texas Roadhouse,Adams,231 W 104th Ave,1,6,7,49
Texas Roadhouse,Adams,3738 Eagle Blvd,2,2,4,52
Texas Roadhouse,Arapahoe,14200 E Iliff Ave,1,5,6,50
Texas Roadhouse,Arapahoe,3696 Natches Ct,4,4,8,48
Texas Roadhouse,Douglas,11205 S Parker Rd,3,7,10,46
Thai Basil,Adams,1281 E 120th Ave Unit F,5,7,12,44
Thai Bite of Fusion,Arapahoe,1155 S Tower Rd # C,2,1,3,53
Thai Flavor,Arapahoe,1014 S Peoria St,6,9,15,41
Thai Garden,Arapahoe,16911 E Quincy Ave Unit A7,7,5,12,44
Thai Noodle and Cigarette,Adams,7141 Irving St Unit A-1,1,3,4,52
Thai Panda,Arapahoe,5616 S Gibraltar Way Unit D,2,2,4,52
Thai and Chinese Express,Arapahoe,3531 S Logan St Unit M,5,2,7,49
Thank Sool,Arapahoe,2222 S Havana St Unit E,2,0,2,54
That Personal Touch Catering,Arapahoe,6553 S Revere Pkwy,4,2,6,50
Thimmig Elementary,Adams,11453 Oswego St,2,0,2,54
Thirsty 30,Arapahoe,5428 S Parker Rd Unit 9,3,1,4,52
Thirstys Sports Pub,Adams,1294 E 104th Ave,2,3,5,51
Thorncreek Golf Course,Adams,13555 Washington St,3,0,3,53
Thornton Area Multi Purpose Senior Center,Adams,9471 Dorothy Blvd,4,2,6,50
Thornton Elementary,Adams,991 Eppinger Blvd,0,0,0,56
Thornton High School,Adams,9351 Washington St,2,4,6,50
Thornton Middle School,Adams,9451 Hoffman Way,1,0,1,55
Thornton Wingstop,Adams,3732 E 120th Ave,2,6,8,48
Thousands of Woks Chinese Restaurant,Adams,3041 W 92nd Ave,5,5,10,46
Three Little Griddles,Arapahoe,6040 S Gun Club Rd F2,5,3,8,48
Three Little Griddles DTC,Arapahoe,10111 Inverness Main St Ste B,7,6,13,43
Thunder Ridge High School,Douglas,1991 Wildcat Reserve Pkwy,0,2,2,54
Thunder Ridge Middle School,Arapahoe,5250 S Piccadilly Rd,0,2,2,54
Tia Maria Mexican Restaurant,Adams,7260 Pecos St,1,6,7,49
Timber Trail Elementary,Douglas,690 W Castle Pines Pkwy,0,4,4,52
Timberline Elementary,Arapahoe,5500 S Killarney St,0,1,1,55
Timberline Tavern,Douglas,3237 Summer Wind Ln,3,3,6,50
Time for Change,Adams,8031 I-76 Service Rd,0,0,0,56
Tin Cup,Arapahoe,50 S Peoria St,6,4,10,46
Tin Cup at Meadowhills,Arapahoe,3609 S Dawson St,2,1,3,53
Tocabe,Arapahoe,8181 E Arapahoe Rd Unit C,1,2,3,53
Today Express,Adams,9191 N Washington St,9,8,17,39
Tokayo Sushi and Ramen,Arapahoe,3712 S Broadway,8,4,12,44
Tokyo Joes,Adams,1005 W 120th Ave Ste 300,1,8,9,47
Tokyo Joes,Arapahoe,1000 S Colorado Blvd,1,0,1,55
Tokyo Joes,Arapahoe,13950 E Mississippi Ave Unit A,0,4,4,52
Tokyo Joes,Arapahoe,2320 S Parker Rd,1,4,5,51
Tokyo Joes,Arapahoe,23955 E Plaza Ave Ste 107,5,3,8,48
Tokyo Joes,Arapahoe,4950 S Yosemite St Unit F3,1,2,3,53
Tokyo Joes,Arapahoe,6380 S Fiddlers Green Cir Unit 108B,1,2,3,53
Tokyo Joes,Arapahoe,6775 S Cornerstar Way Unit A,4,5,9,47
Tokyo Joes,Arapahoe,6879 S Vine St Ste B7,3,2,5,51
Tokyo Joes,Arapahoe,8225 S Chester St Unit 106,3,5,8,48
Tokyo Joes,Arapahoe,8727 E Dry Creek Rd Unit F,3,4,7,49
Tokyo Joes,Arapahoe,901 W Hampden Ave Unit 104,5,3,8,48
Tokyo Joes,Douglas,19240 E Lincoln Ave Ste E,1,4,5,51
Tokyo Joes,Douglas,6642 Timberline Rd Unit 101,2,3,5,51
Tokyo Joes,Douglas,820 New Memphis Ct,6,7,13,43
Tokyo Joes,Douglas,9131 S Broadway,2,6,8,48
Tokyo Teriyaki,Adams,11455 Washington St Unit A,5,0,5,51
Toleys on the Creek,Arapahoe,16728 E Smoky Hill Rd Unit C,8,8,16,40
Tollgate Elementary,Arapahoe,701 S Kalispell Way,0,0,0,56
Tonys Meats,Arapahoe,4991 E Dry Creek Rd,4,6,10,46
Tonys Meats,Douglas,874 W Happy Canyon Rd,1,6,7,49
Tonys Meats Commissary and Catering,Arapahoe,12001 E Caley Ave Unit A,1,5,6,50
Top Pho,Arapahoe,11697 E Colfax Ave,10,9,19,37
Top of the Hills,Adams,1680 W 100th Ave,0,3,3,53
Topgolf,Arapahoe,10601 E Easter Ave,3,3,6,50
Topgolf Thornton,Adams,16011 Grant St,4,2,6,50
Torchys Tacos,Arapahoe,8505 E Arapahoe Rd,1,2,3,53
Torchys Tacos,Douglas,1515 Park Central Dr Ste 100,3,1,4,52
Tortas y Tacos El Chino,Arapahoe,796 Peoria St,4,10,14,42
Tortilleria La Amapola,Arapahoe,15376 E Alameda Pkwy,3,2,5,51
Tortilleria Las Dos Americas,Adams,6065 Quebec St,9,8,17,39
Tortisimas,Arapahoe,15021 E Mississippi Ave,4,4,8,48
Toss Asian Cafe,Douglas,909 Park St,8,13,21,35
Total Long Term Health Care,Adams,445 E 124th Ave,1,3,4,52
Town of Parker Field House Concession,Douglas,18700 E Plaza Dr,1,0,1,55
Trader Joes,Arapahoe,5910 S University Blvd Unit E-1,2,1,3,53
Trailblazer Elementary,Douglas,9760 S Hackberry St,0,2,2,54
Trails West Elementary,Arapahoe,5400 S Waco St,0,1,1,55
Trailside Academy,Adams,2300 W 68th Ave,0,0,0,56
Trailside Saloon,Adams,10360 Colorado Blvd,1,0,1,55
Trappers Chophouse,Douglas,19308 Cottonwood Dr,3,3,6,50
Trattoria Dionisia,Douglas,10403 S Parker Rd,3,3,6,50
Treat America,Adams,995 W 122nd Ave,2,3,5,51
Tres Margaritas Family Mexican Restaurant,Arapahoe,501 E County Line Rd,5,5,10,46
Trestles Coastal Cuisine,Douglas,880 W Happy Canyon Rd Ste 150,2,4,6,50
Trompeau Bakery,Arapahoe,2950 S Broadway Unit D,4,2,6,50
Tropical Smoothie Cafe,Arapahoe,9615 E County Line Rd Unit D,1,4,5,51
Tru by Hilton,Douglas,9741 Park Meadows Dr,2,0,2,54
Tsai Shen Garden,Arapahoe,15200 E 6th Ave Unit 2,9,12,21,35
Turn II Bingo,Adams,7139 Pecos St,2,1,3,53
Turn of the Century Bingo,Arapahoe,1921 S Havana St,3,4,7,49
Turnberry Elementary,Adams,13069 E 106th Pl,1,1,2,54
Twin Dragon Restaurant,Arapahoe,3021 S Broadway,6,6,12,44
Twin Peaks,Arapahoe,8840 E Arapahoe Rd,5,3,8,48
Twisters,Arapahoe,1750 S Buckley Rd,4,6,10,46
Twisters,Douglas,10555 S Parker Rd,1,7,8,48
Two Sticks Cafe,Adams,5036 W 92nd Ave Unit A,4,5,9,47
Tyco Integrated Security,Arapahoe,14200 E Exposition Ave,3,0,3,53
Tzatzikis Restaurant,Arapahoe,5919 S University Blvd,5,6,11,45
U Save Mart,Adams,6590 Monaco St,2,3,5,51
UC Health Highlands Ranch Hospital,Douglas,1500 Park Central Dr,1,0,1,55
USA Food and Gas,Adams,1720 E 112th Ave,3,2,5,51
Udom Thai,Arapahoe,7412 S University Blvd,6,1,7,49
Ugly Dog Sports Cafe,Adams,1345 Cortez St,5,6,11,45
Uncle Maddios Pizza Joint,Arapahoe,10601 E Garden Dr Unit 105,2,7,9,47
Uncle Zhou Restaurant,Arapahoe,12203 E Iliff Ave Unit D,3,2,5,51
Uncorked Kitchen,Arapahoe,8171 S Chester St,3,2,5,51
Undici Ristorante,Arapahoe,1200 E Hampden Ave,2,1,3,53
Union American Bistro,Douglas,3 Wilcox St,4,7,11,45
Union Building School,Adams,3455 W 72nd Ave,1,0,1,55
United Chinese Restaurant 2,Adams,4150 E 128th Ave,7,9,16,40
Urban Burma,Arapahoe,10180 E Colfax Ave Unit 190,5,0,5,51
Urban Eatery Daylight Donuts,Adams,14352 Lincoln St,5,6,11,45
Urban Plaza Cafe,Arapahoe,1074 S Ironton St Unit C,3,2,5,51
VFW Currie Toles Post 4444,Adams,7100 Fairfax Dr,3,2,5,51
VFW Post 7945,Adams,10217 Quivas St,4,5,9,47
VFW Post 9644,Arapahoe,2680 W Hampden Ave,3,2,5,51
VY Sushi and Asian Fine Dining,Douglas,9964 S Twenty Mile Rd,8,6,14,42
Valley Country Club,Arapahoe,14601 Country Club Dr,6,1,7,49
Vanguard Classical School,Arapahoe,17101 E Ohio Dr,1,0,1,55
Varsity Inn The,Arapahoe,7500 S University Blvd Unit 116,0,2,2,54
Vassar Elementary,Arapahoe,18101 E Vassar Pl,0,2,2,54
Vaughn Elementary,Arapahoe,1155 Vaughn St,0,2,2,54
Venice Restaurant,Arapahoe,5946 S Holly St,10,7,17,39
Venue The,Adams,1451 Cortez St Ste F,3,2,5,51
Venus Event Center,Adams,7150 Ivy St,3,1,4,52
Versatile,Adams,6496 Highway 2,3,8,11,45
Via Baci,Douglas,10005 Commons St Ste 200,0,6,6,50
Vibe Foods,Douglas,9500 Heritage Hills Cir Unit 100,1,0,1,55
Vibra Hospital of Denver,Adams,8451 Pearl St,3,6,9,47
Victorias Market,Adams,1650 Tower Rd,5,6,11,45
Victory Prep Academy,Adams,5701 Quebec St,3,0,3,53
Viet Pho LLC,Douglas,9231 E Lincoln Ave Ste 400,7,8,15,41
Vietnamese Cafe,Adams,3744 E 104th Ave,5,9,14,42
View House,Arapahoe,2680 W Main St,3,2,5,51
ViewHouse 20,Arapahoe,7101 S Clinton St,5,9,14,42
Vikan Middle School,Adams,879 Jessup St,2,1,3,53
Villa Italian Kitchen,Douglas,8401 Park Meadows Center Dr Unit 3052,5,6,11,45
Villa Pizza,Douglas,5050 Factory Shops Blvd Unit 5,4,5,9,47
Village Cafe,Arapahoe,5600 S Quebec St Unit 120A,2,0,2,54
Village East Elementary,Arapahoe,1433 S Oakland St,0,2,2,54
Village Inn 025,Adams,8370 Sherman St,2,4,6,50
Village Inn 110078,Adams,15395 E Colfax Ave,4,10,14,42
Village Inn 110147,Arapahoe,15200 E Iliff Ave,3,5,8,48
Village Inn 159,Douglas,19502 E Parker Square Dr,1,6,7,49
Village Inn 578,Adams,395 W 120th Ave,8,6,14,42
Village Inn 591,Douglas,23 Centennial Blvd,1,3,4,52
Village Inn 774,Arapahoe,6370 S Parker Rd,7,8,15,41
Village Inn 777,Arapahoe,18601 E Hampden Ave,3,3,6,50
Village Inn 859,Arapahoe,24102 E Prospect Ave,7,4,11,45
Village Inn 865,Adams,16775 Washington St,1,3,4,52
Village Inn Restaurant,Adams,710 Platte River Blvd,6,6,12,44
Village Pub,Adams,9150 Huron St,3,7,10,46
Vines Wine Bar and Bistro,Douglas,19501 Mainstreet,3,7,10,46
Virginia Court Elementary,Arapahoe,395 S Troy St,1,0,1,55
Virriaria La Guera Michoacana,Adams,7272 Locust St,2,2,4,52
Visa DPS,Douglas,8910 Ridgeline Blvd,1,1,2,54
Vista Peak 9 thru 12/ Serving Kitchen,Arapahoe,24500 E 6th Ave,2,2,4,52
Vista Peak P-8 Exploratory,Arapahoe,24551 E 1st Pl,1,0,1,55
Vista Vino Modern Grill,Douglas,611 Wilcox St Unit A,2,0,2,54
Vitality Bowls,Douglas,830 New Memphis Ct Unit B-100,1,8,9,47
Vitamin Cottage Natural Grocers,Arapahoe,6774 S University Blvd Ste A,1,1,2,54
Viva Burrito Company,Adams,7550 Pecos St,5,6,11,45
Vivi Pho,Arapahoe,780 S Colorado Blvd Unit B,6,3,9,47
Vivi Pho Arapahoe,Arapahoe,11001 E Arapahoe Pl Unit B-7,5,0,5,51
Volcano Asian Cuisine,Arapahoe,9632 E Arapahoe Rd Unit 26,9,10,19,37
Volcano Tea House,Arapahoe,2781 S Parker Rd,7,1,8,48
Vons Chicken,Arapahoe,12101 E Iliff Ave Ste K,2,2,4,52
Voulas Kitchen,Arapahoe,15151 E Alameda Pkwy,4,1,5,51
WC Dining Services,Adams,3645 W 112th Ave,4,8,12,44
Waddell Ballfields,Adams,2940 Cottonwood Dr,0,1,1,55
Wafels and Dinges,Arapahoe,8401 S Park Meadows Center Dr Unit 5576,3,1,4,52
Waffle House 1107,Arapahoe,201 E County Line Rd,2,4,6,50
Waffle House 1516,Douglas,19312 E Plaza Dr,4,6,10,46
Waffle House 1566,Arapahoe,12880 E Mississippi Ave,3,3,6,50
Waffle House 1598,Douglas,222 Wolfensberger Rd,2,5,7,49
Waffle House 606,Adams,8401 Pearl St,4,4,8,48
Wagon Wheel Skating Rink,Adams,14501 Brighton Rd,1,8,9,47
Wahoos Fish Taco,Arapahoe,9617 E County Line Rd Unit A,5,7,12,44
Wahoos Fish Taco,Douglas,870 Cpl Max Donahue Ln,3,5,8,48
WalMart,Arapahoe,15240 E Iliff Ave,3,1,4,52
WalMart 4567,Adams,7101 E 128th Ave,3,3,6,50
WalMart Neighborhood Market 4747,Adams,10755 N Washington St,3,2,5,51
Walgreens #03091,Arapahoe,8151 S Quebec St,0,0,0,56
Walgreens #03298,Arapahoe,3080 S Broadway,0,1,1,55
Walgreens #07432,Arapahoe,2697 W Belleview Ave,0,0,0,56
Walgreens #07451,Arapahoe,16440 E Arapahoe Rd,0,0,0,56
Walgreens #10175,Arapahoe,12011 E Iliff Ave,0,0,0,56
Walgreens #10455,Arapahoe,2281 E Arapahoe,1,1,2,54
Walgreens #10704,Arapahoe,8959 E Dry Creek Rd,1,4,5,51
Walgreens #12423,Arapahoe,123 E Belleview Ave,1,1,2,54
Walgreens #17807,Arapahoe,100 E Mineral Ave,0,0,0,56
Walgreens 02641,Douglas,4175 E Wildcat Reserve Pkwy,0,1,1,55
Walgreens 03207,Adams,4001 E 120th Ave,0,1,1,55
Walgreens 03489,Douglas,9390 S University Blvd,0,2,2,54
Walgreens 04025,Adams,5190 W 120th Ave,0,0,0,56
Walgreens 04470,Arapahoe,20051 E Smoky Hill Rd,0,0,0,56
Walgreens 04667,Adams,1601 W 84th Ave,0,2,2,54
Walgreens 04894,Adams,8799 Washington St,1,3,4,52
Walgreens 04952,Douglas,9141 S Broadway,1,3,4,52
Walgreens 05261,Douglas,19028 Lincoln Ave,1,1,2,54
Walgreens 05538,Douglas,6650 Timberline Rd,0,2,2,54
Walgreens 05644,Adams,750 E 120th Ave,0,0,0,56
Walgreens 05837,Adams,4351 E 104th Ave,0,2,2,54
Walgreens 06213,Adams,10390 Federal Blvd,0,2,2,54
Walgreens 06344,Adams,1821 E Bridge St Ste A,0,0,0,56
Walgreens 06514,Douglas,14 E Allen St,1,2,3,53
Walgreens 06552,Adams,7211 Federal Blvd,0,3,3,53
Walgreens 06987,Douglas,355 S Wilcox St,0,1,1,55
Walgreens 07138,Douglas,13143 S Parker Rd,0,0,0,56
Walgreens 07837,Douglas,7370 Lagae Rd,2,2,4,52
Walgreens 07955,Adams,13611 N Colorado Blvd,1,2,3,53
Walgreens 12422,Adams,15310 E 104th Ave,1,1,2,54
Walmart,Arapahoe,14000 E Exposition Ave,3,1,4,52
Walmart 1231,Adams,9901 Grant St,2,3,5,51
Walmart 1659,Adams,60 W Bromley Ln,4,7,11,45
Walmart 1689,Arapahoe,5650 S Chambers Rd,0,0,0,56
Walmart 2752,Adams,5990 Dahlia St,5,3,8,48
Walmart 2892,Douglas,11101 S Parker Rd,3,3,6,50
Walmart 3313,Arapahoe,10900 E Briarwood Ave,1,3,4,52
Walmart 3566,Arapahoe,9400 E Hampden Ave,5,7,12,44
Walmart 3867,Adams,200 W 136th Ave,3,6,9,47
Walmart 5137,Arapahoe,6101 S Aurora Pkwy,0,0,0,56
Walmart Market 3126,Arapahoe,16746 E Smoky Hill Rd,4,5,9,47
Walmart Market 3128,Arapahoe,1442 S Parker Rd,1,1,2,54
Walmart Neighboorhood Market,Arapahoe,10400 E Colfax Ave,3,1,4,52
Walmart Neighborhood Market,Adams,7170 N Federal Blvd,1,2,3,53
Walmart Neighborhood Market,Adams,850 E 88th Ave,1,1,2,54
Walmart Neighborhood Market,Arapahoe,21475 E Quincy Ave,0,2,2,54
Walmart Store 2751,Arapahoe,601 Englewood Pkwy,1,1,2,54
Walmart Super Center 1252,Douglas,6675 Business Center Dr,4,4,8,48
Walmart Super Center 984,Douglas,133 Sam Walton Ln,1,2,3,53
Walnut Hills Elementary,Arapahoe,8195 E Costilla Blvd,1,1,2,54
Walters Pizza,Arapahoe,5194 S Lowell Blvd,2,8,10,46
Wander Culinari Lust,Arapahoe,2045 S Valentia St Unit 17,1,1,2,54
Wangs Gourmet,Arapahoe,12 E Arapahoe Rd,7,5,12,44
Wanna Poke and Ramen,Arapahoe,16748 E Smoky Hill Rd Unit 9A,7,6,13,43
Washoku Japanese Cuisine,Douglas,9226 Park Meadows Dr Ste 100,4,9,13,43
Watda Pho,Arapahoe,501 W Hampden Ave,3,0,3,53
Water World/ Aokees Desserts,Adams,1850 W 89th Ave,1,2,3,53
Waters Edge Winery,Arapahoe,2101 E Arapahoe Rd Unit 101,5,1,6,50
Waterton Tavern,Douglas,8361 N Rampart Range Rd Unit B107,7,9,16,40
Waterway Gas and Wash,Arapahoe,16330 E Arapahoe Rd,0,0,0,56
Waterway Gas and Wash,Douglas,8640 S Quebec St,0,2,2,54
Wave the Grain,Arapahoe,8172 S Holly St,4,3,7,49
Wayback Burgers,Arapahoe,5098 S Federal Blvd Unit B,3,2,5,51
Wedgewood Brittany Hill,Adams,9350 Grant St,6,5,11,45
Welby Community School,Adams,1200 E 78th Ave,0,0,0,56
Welsh Dragon Tea Shoppe,Arapahoe,8400 E Iliff Ave Unit 7,1,1,2,54
Wendys,Adams,15581 E 104th Ave,2,1,3,53
Wendys,Adams,4880 E Bromley Ln,2,6,8,48
Wendys,Adams,70 W Bromley Ln,2,8,10,46
Wendys,Arapahoe,1255 S Havana St,0,1,1,55
Wendys,Douglas,875 Kinner St,5,9,14,42
Wendys 047 0559,Adams,7397 Federal Blvd,2,2,4,52
Wendys 047 0568,Adams,8970 Washington St,3,0,3,53
Wendys 047 0697,Arapahoe,15400 E Colfax Ave,0,3,3,53
Wendys 047 0818,Adams,4851 E 60th Ave,4,0,4,52
Wendys 047 0855,Arapahoe,3110 S Parker Rd,2,0,2,54
Wendys 047 0879,Adams,5775 Logan St,0,3,3,53
Wendys 047 0976,Arapahoe,16901 E Iliff Ave,4,2,6,50
Wendys 047 10501,Douglas,9365 Hepburn St,4,3,7,49
Wendys 047 10902,Arapahoe,3435 Salida St,1,1,2,54
Wendys 047 11190,Arapahoe,15297 E Mississippi Ave,3,2,5,51
Wendys 047 1660,Arapahoe,8040 S Broadway,2,0,2,54
Wendys 047 2014,Arapahoe,4250 E Alameda Ave,4,2,6,50
Wendys 047 2091,Adams,1500 E 104th Ave,6,2,8,48
Wendys 047 2233,Adams,10335 Federal Blvd,1,3,4,52
Wendys 047 2620,Adams,6290 Sheridan Blvd,0,2,2,54
Wendys 047 2664,Douglas,9485 S University Blvd,4,6,10,46
Wendys 047 4854,Arapahoe,9200 E Arapahoe Rd,5,8,13,43
Wendys 047 7726,Adams,2681 E 120th Ave,4,4,8,48
Wendys 047 7742,Arapahoe,5155 S Broadway,1,3,4,52
Wendys 047 8256,Arapahoe,18700 E Hampden Ave,2,3,5,51
Wendys 047 8257,Douglas,16931 Lincoln Ave,1,4,5,51
Wendys 047 8268,Arapahoe,6240 S Gun Club Rd,5,2,7,49
Wendys 047 8969,Arapahoe,6721 S Potomac St,0,1,1,55
Wendys 047 8970,Douglas,566 E Castle Pines Pkwy,3,5,8,48
Wendys 047 9067,Adams,4101 E 136th Ave,3,2,5,51
Wendys 11595,Douglas,9185 Crown Crest Blvd,0,0,0,56
Wendys 11623,Adams,150 E 144th Ave,0,2,2,54
Wendys 4585,Adams,12040 Melody Dr,3,5,8,48
Wendys 8808,Adams,4860 W 120th Ave,5,2,7,49
Werthwhile Inn,Adams,7390 Highway 2,1,2,3,53
West Main Tap Room and Grill,Douglas,18595 Mainstreet Ste 100,6,5,11,45
West Middle School,Arapahoe,5151 S Holly St,1,0,1,55
West Ridge Elementary,Adams,13102 Monaco St,1,2,3,53
Western Golf Hospitality,Adams,10801 Legacy Ridge Pkwy,4,7,11,45
Westgate Community School,Adams,12500 Washington St,0,1,1,55
Westminster Elementary/ SAT,Adams,7482 Irving St,0,1,1,55
Westminster Elks BPOE Lodge 2227,Adams,3850 Elk Dr,4,3,7,49
Westminster Hampton,Adams,5030 W 88th Pl,5,1,6,50
Westminster High School/ Main Kitchen and Outtakes,Adams,6933 Raleigh St,1,7,8,48
Westminster Residence Inn,Adams,5010 W 88th Pl,3,2,5,51
Westminster Wishbone,Adams,9701 Federal Blvd,3,7,10,46
Westview Elementary,Adams,1300 Roseanna Dr,0,2,2,54
Westys Cafe,Adams,6871 Lowell Blvd,5,6,11,45
Wetzels Pretzels,Adams,13801 Grant St Ste 515,4,4,8,48
What the Pho,Douglas,10971 S Parker Rd,3,6,9,47
What-A-Sub,Arapahoe,5680 Greenwood Plaza Blvd Ste 105,3,1,4,52
Wheeling Elementary,Arapahoe,472 S Wheeling St,0,0,0,56
Wheelz Bar and Grill,Arapahoe,2490 W Hampden Ave,7,4,11,45
Which Which Superior Sandwiches,Adams,14647 Delaware St Unit 1400,0,3,3,53
Which Wich,Arapahoe,8331 Willow St Unit E,1,3,4,52
Which Wich Superior Sandwiches 507,Arapahoe,13700 E Colfax Ave Unit H,1,4,5,51
Whichwich,Douglas,1100 Sgt Jon Stiles Dr Unit 107,2,2,4,52
Whiskey Biscuit The,Arapahoe,3299 S Broadway Unit,4,1,5,51
Whispers,Arapahoe,1535 S Havana St,1,1,2,54
White Chocolate Grill,Douglas,8421 Park Meadows Center Dr,5,11,16,40
Whole Foods,Adams,4451 Main St,0,4,4,52
Whole Foods Market,Arapahoe,870 S Colorado Blvd,1,8,9,47
Whole Foods Market,Douglas,9366 S Colorado Blvd Unit B,3,4,7,49
Whole Foods Market SGN 10273,Arapahoe,6853 S York St Unit 119,3,2,5,51
Wholly Cannoli Cafe,Arapahoe,22691 E Aurora Pkwy Unit,3,5,8,48
Wichos Tacos,Adams,9698 E Montview Blvd,9,6,15,41
Wild Basil,Arapahoe,8247 S Holly St,8,8,16,40
Wild Blue Yonder Brewing CO,Douglas,519 Wilcox St,5,8,13,43
Wild Ginger,Arapahoe,399 W Littleton Blvd,7,4,11,45
Wild Goose Coffee,Arapahoe,6399 S Santa Fe Dr Unit 300,1,0,1,55
Wild Sage Deli,Arapahoe,720 S Colorado Blvd Unit 195A,0,1,1,55
Wild Sage Deli Quadrant,Arapahoe,5445 DTC Pkwy Lwr Level,2,0,2,54
Wildcat Elementary,Douglas,6585 Lions Head Pkwy,2,1,3,53
Wilder Elementary,Arapahoe,4300 W Ponds Cir,1,1,2,54
Willis A Tarver Elementary,Adams,3500 Summit Grove Pkwy,1,0,1,55
Willow Creek Elementary,Arapahoe,7855 S Willow Way,0,0,0,56
Winchells Donuts,Adams,7930 Sheridan Blvd,3,6,9,47
Winchells Donuts 533,Arapahoe,15195 E Hampden Ave,3,5,8,48
Windows,Douglas,3237 Summer Wind Ln,3,3,6,50
Wine Experience Cafe,Arapahoe,6240 S Main St,2,10,12,44
Wing Cave and Grill Inc (The),Adams,1450 W 104th Ave,1,5,6,50
Wing Hut The,Arapahoe,15473 E Hampden Ave Unit K,1,0,1,55
Wing Man,Adams,1555 E Bridge St Unit B,1,9,10,46
Wing Slingers,Adams,8458 Federal Blvd,1,5,6,50
Wing Slingers,Arapahoe,7325 E Iliff Ave,8,10,18,38
Wing Stop,Arapahoe,14221 E Cedar Ave Unit D,1,2,3,53
Wing Stop 741,Arapahoe,16883 E Iliff Ave,1,2,3,53
Wing Stop 745,Arapahoe,6140 S Gun Club Rd Unit K1,0,3,3,53
Wing Stop of Glendale,Arapahoe,1108 S Colorado Blvd,0,0,0,56
Wing Stop of South Thornton,Adams,9645 Washington St Ste 130,5,3,8,48
Wingate By Wyndham,Arapahoe,8000 E Peakview Ave,4,1,5,51
Wingin It,Arapahoe,8200 S Quebec St Unit A2A,1,7,8,48
Wings and More,Adams,1407 W 84th Ave Unit D3A,3,1,4,52
Wingstop 742,Arapahoe,1175 S Havana St Unit A2,0,0,0,56
Wingstop 747,Douglas,9559 S University Blvd Unit 106,1,6,7,49
Wingstop 749,Adams,4962 E 62nd Ave Unit A2,0,1,1,55
Winners Bingo,Arapahoe,13678 E Alameda Ave,1,1,2,54
Winston Hills Ribs and Stuff,Arapahoe,5090 E Arapahoe Rd Unit B1,7,5,12,44
Winstons Coffee,Arapahoe,7465 E Arapahoe Rd,0,0,0,56
Wonder Tea,Arapahoe,12303 E Mississippi Ave Unit 141,0,9,9,47
Wood Paddle Pizza,Arapahoe,17060 E Quincy Ave,1,4,5,51
Woodglen Elementary,Adams,11717 Madison St,1,0,1,55
Woodgrain Bagel and Deli,Adams,13120 E 19th Ave,4,1,5,51
Woody Creek,Douglas,8515 Park Meadows Center Dr,6,4,10,46
Woodys Wings,Arapahoe,700 S Buckley Rd Unit G,5,4,9,47
Woodys Wings 2,Arapahoe,313 Havana St,0,5,5,51
Woodys Wings N Things and Gourmet Chinese,Adams,6817 Lowell Blvd,4,6,10,46
Woolleys Classic Suites,Arapahoe,16450 E 40th Cir,3,3,6,50
Woori Banchan,Arapahoe,2648 S Parker Rd Unit 9,7,6,13,43
World Food Bazaar,Arapahoe,242 Havana St Unit C,2,4,6,50
World Juice Bar,Adams,5036 W 92nd Ave,5,4,9,47
Wortlewoods Smokepit,Adams,6200 E 64th Ave,4,4,8,48
Xin Yang Restaurant,Adams,10185 Washington St,7,7,14,42
Y Mart 1,Adams,10770 Washington St,2,6,8,48
Ya Ting,Arapahoe,15622 E 6th Ave,5,8,13,43
Ya Yas Euro Cafe,Arapahoe,8310 E Belleview Ave,5,4,9,47
Yak and Yeti Restaurant,Adams,305 Pavilions Pl,3,11,14,42
Yale Elementary,Arapahoe,16001 E Yale Ave,0,1,1,55
Yannis,Arapahoe,5425 Landmark Pl Unit D109,7,8,15,41
Yard House Restaurant,Douglas,8437 Park Meadows Center Dr,3,4,7,49
Yareths Mexican Fast Food,Adams,4403 W 52nd Ave,4,3,7,49
Yemen Restaurant,Arapahoe,2353 S Havana St Unit D15A,4,5,9,47
Yi Asian Express,Adams,15077 E Colfax Ave,8,9,17,39
Yogurt Brothers,Adams,4680 W 120th Ave Unit 100,0,2,2,54
Yogurt Yum,Adams,3969 E 120th Ave,0,1,1,55
Yolandas Tacos,Douglas,204 Wilcox St Unit B,3,6,9,47
Yolandas Tacos II,Arapahoe,9612 E Arapahoe Rd,9,10,19,37
Yong Gung Restaurant,Arapahoe,2040 S Havana St,3,8,11,45
York International School,Adams,9200 York St,1,1,2,54
Yorkshire Fish and Chips,Adams,7275 Pecos St,2,3,5,51
Your Pie,Adams,14342 Lincoln St,3,1,4,52
Youth Sports Concessions,Adams,1100 Voiles St,2,4,6,50
Yuan Palace Mongolian BBQ Company,Arapahoe,7555 E Arapahoe Rd Unit,2,2,4,52
Yum Asian Fusion Cuisine and Sushi,Adams,18220 E 104th Ave Unit 107,6,9,15,41
Yum Yum Cake House,Arapahoe,2680 S Havana St Unit AA,3,9,12,44
Yummy Pho and Noodles,Douglas,18671 E Mainstreet Unit D,2,10,12,44
Yutaka Japanese Bistro,Douglas,11411 S Twenty Mile Rd Ste 105,4,9,13,43
Zabbracci,Douglas,312 Wilcox St Ste 101,3,4,7,49
Zaika Indian,Douglas,78 E Allen St Ste 108,3,8,11,45
Zaika Indian Cusine,Arapahoe,151 W Mineral Ave Unit,5,7,12,44
ZamZam Halal International Market & Deli,Arapahoe,7449 E Iliff Ave,3,6,9,47
Zeal Food for Enthusiasts,Arapahoe,5370 Greenwood Plaza Blvd Unit 107,5,0,5,51
Zen Asian Bistro and Sushi,Adams,11940 Bradburn Blvd,7,7,14,42
Zephyr Lounge and Motel,Arapahoe,11940 E Colfax Ave,6,4,10,46
Zero Degrees,Arapahoe,13650 E Colfax Ave Ste C,6,4,10,46
Zig Zag Smoking Burger Meatball,Arapahoe,9220 E Arapahoe Rd,6,3,9,47
Ziggis Thornton,Adams,14325 N Lincoln St,3,3,6,50
Zion Lutheran School,Adams,1400 Skeel St,2,3,5,51
Zoes Kitchen,Douglas,1515 Park Central Dr Ste 100,2,2,4,52
Zoes Kitchen,Douglas,4987 Factory Shops Blvd Unit 100,2,4,6,50
Zoes Kitchen 284,Adams,4550 Main St Unit 600,3,7,10,46
Zoes Lounge,Arapahoe,2893 S Broadway,2,2,4,52
Zomo Restaurant,Arapahoe,3457 S Broadway,5,2,7,49
Zona Cero Lounge,Adams,8980 Federal Blvd,6,3,9,47
